17 17 17 16 17 17 17 18 19 20 21 19 23 21 20 19 22 20 23 24 24 25 25 25 25 26 25 28 26 26 26 26 25 25 25 25 26 27 27 28 
17 16 17 17 17 17 18 20 20 19 21 23 20 21 21 22 20 24 25 24 25 24 25 25 25 26 28 26 26 26 26 26 25 25 25 25 26 28 27 27 
17 17 16 16 18 18 18 21 22 23 21 19 21 22 19 21 23 26 27 24 25 27 25 25 28 26 28 26 26 26 26 23 25 25 26 26 29 27 26 26 
16 17 17 17 18 19 20 23 24 21 22 22 23 23 21 22 24 27 30 25 25 25 25 25 28 26 26 27 25 24 26 26 26 26 27 26 27 26 27 27 
18 18 18 20 18 20 22 25 26 19 20 26 24 24 25 26 24 29 27 27 26 26 25 25 25 25 27 27 27 26 26 26 26 25 25 27 27 27 27 27 
18 19 18 19 22 22 24 26 28 22 21 25 25 27 28 26 28 27 27 26 26 25 25 25 25 26 26 27 27 26 26 26 25 26 27 26 27 27 28 28 
18 18 22 22 22 24 27 29 30 21 27 23 27 27 27 26 30 28 29 26 25 26 25 24 24 27 29 27 25 26 26 26 26 26 27 27 26 28 28 29 
19 22 21 23 24 26 28 31 31 28 25 31 28 28 26 28 26 30 29 25 24 24 23 24 25 26 27 25 26 26 27 27 27 27 27 26 28 29 29 29 
21 20 23 23 25 27 30 31 32 26 31 26 26 27 27 25 29 29 28 24 24 24 25 24 25 27 26 26 26 25 27 26 27 26 27 28 28 29 29 29 
22 22 23 23 22 23 20 24 23 23 27 27 27 27 27 27 27 29 30 24 25 24 27 24 23 24 21 24 22 22 26 27 25 26 26 27 25 28 26 25 
22 22 22 22 21 22 23 23 23 23 28 27 27 27 27 27 28 30 30 24 25 27 23 23 22 22 24 22 24 25 26 26 26 25 25 27 27 25 24 24 
22 23 23 21 24 21 25 23 24 24 27 27 27 27 28 28 32 31 31 27 26 23 23 22 25 22 22 25 27 28 27 26 25 23 28 26 29 25 25 25 
23 21 21 19 21 24 20 23 23 26 26 27 27 27 29 30 29 30 31 25 23 23 22 21 21 23 23 28 27 29 24 26 23 24 26 25 24 27 24 24 
19 21 19 19 22 19 23 25 24 25 27 27 28 27 30 29 31 32 31 24 23 21 23 21 23 22 25 27 29 28 26 24 24 25 25 24 25 24 23 22 
20 20 21 22 22 23 25 26 26 27 27 27 29 29 30 31 32 33 33 22 22 30 27 28 29 25 24 27 24 24 24 24 23 22 22 23 24 22 22 22 
20 21 21 24 24 25 25 27 28 29 27 28 30 30 30 30 33 33 34 26 26 27 29 29 29 26 27 24 24 24 24 24 22 22 22 23 23 22 22 22 
21 21 24 24 25 26 27 28 28 29 28 32 31 32 32 33 32 35 36 23 31 30 28 25 24 25 26 24 24 24 24 23 22 21 21 24 22 22 20 20 
22 24 24 26 26 27 29 29 29 29 31 30 32 32 33 33 35 36 36 32 27 32 25 26 23 24 23 24 23 24 23 22 22 21 21 21 23 20 21 21 
24 23 25 26 27 29 28 29 28 30 30 32 32 31 33 34 35 36 37 29 34 27 25 24 25 23 23 24 23 22 22 21 21 22 21 23 21 21 21 21 
24 24 23 23 25 24 29 26 28 29 29 28 29 28 28 28 30 27 26 26 27 27 26 24 24 24 22 25 26 26 27 24 28 25 24 23 24 22 23 24 
23 23 24 25 27 27 25 29 29 28 27 29 28 29 29 28 29 26 27 28 27 26 24 24 23 25 24 26 26 25 26 28 24 25 24 23 22 24 25 25 
24 23 23 26 23 28 31 30 28 30 29 28 29 30 28 30 24 27 26 26 27 26 24 22 25 23 29 27 28 29 26 25 25 25 22 23 23 25 25 25 
23 26 26 29 30 29 32 29 30 28 28 29 30 30 29 26 29 26 27 27 24 24 23 22 24 27 25 30 29 25 25 23 25 24 23 24 25 24 26 27 
25 25 28 30 31 32 30 28 29 29 28 29 31 31 27 30 26 27 28 27 25 23 22 22 27 24 29 28 28 24 23 24 26 25 25 25 25 26 28 29 
27 27 26 26 30 30 29 29 29 28 27 31 27 26 26 27 25 26 25 25 24 23 26 27 27 28 29 31 33 24 24 31 26 28 29 25 22 27 25 24 
26 26 28 27 27 29 29 30 30 29 28 29 26 27 27 25 26 25 23 23 25 25 27 27 27 30 30 34 34 27 26 27 29 28 28 25 26 24 23 23 
28 27 26 28 28 29 30 31 31 27 30 24 26 24 23 25 28 24 22 22 24 30 29 29 30 30 35 35 35 24 31 28 27 24 23 24 27 23 23 24 
26 28 27 28 30 30 29 31 31 29 26 29 24 24 23 24 22 22 21 22 28 26 29 29 31 32 33 34 35 32 27 32 25 25 22 24 21 24 22 24 
28 27 28 30 29 29 30 32 32 25 30 24 24 23 23 22 22 22 20 21 25 29 30 31 31 33 35 36 37 29 33 25 24 24 24 21 23 23 21 21 
28 27 27 25 24 24 23 24 23 23 25 24 25 25 26 24 28 24 25 26 26 27 26 26 26 26 25 25 23 23 26 25 25 26 26 25 28 24 24 25 
27 27 25 24 23 24 24 23 23 23 25 24 26 26 27 25 24 26 25 25 26 26 26 25 25 24 26 23 23 24 25 24 26 26 27 25 25 25 25 25 
26 26 23 23 25 24 22 22 21 21 24 26 27 28 23 27 27 25 23 22 26 29 26 26 26 25 23 23 22 22 24 30 27 27 24 27 27 25 23 23 
25 23 25 23 23 21 22 20 21 23 25 26 29 29 28 25 27 23 24 22 26 26 28 26 24 23 23 21 21 23 27 25 26 27 28 25 27 25 24 21 
24 25 23 23 20 22 21 23 21 22 25 28 28 29 26 28 24 23 23 24 26 26 25 24 23 23 21 23 23 22 25 27 28 27 25 28 24 22 23 22 
23 22 22 21 21 21 22 22 22 22 25 25 25 24 24 24 23 23 23 23 25 25 23 23 23 22 22 21 20 20 25 23 23 22 22 24 23 22 22 22 
22 21 21 21 20 20 22 22 22 22 25 25 24 23 23 24 23 23 21 21 23 23 23 22 22 22 22 20 20 21 24 24 22 22 22 24 22 22 21 21 
22 21 20 20 21 22 22 22 22 22 25 26 23 23 23 22 25 22 22 23 24 24 22 21 21 22 18 20 20 20 23 21 21 21 21 22 24 21 20 20 
21 19 20 20 21 23 23 22 22 22 24 24 24 23 22 23 21 24 22 22 23 23 23 22 20 20 21 21 20 20 21 20 20 20 22 22 20 20 20 21 
18 20 20 21 21 23 22 22 23 23 24 23 22 21 22 21 22 21 22 21 23 22 21 20 20 21 19 20 21 20 20 20 22 21 21 20 21 21 20 21 
19 20 20 21 22 22 22 23 22 23 23 23 22 22 22 21 22 21 22 22 22 22 21 20 20 20 20 20 20 20 20 20 21 21 21 20 20 21 21 21 
