72 71 71 70 71 70 69 69 68 68 67 68 59 58 58 59 60 59 62 61 61 58 59 58 58 56 61 55 65 55 62 61 58 62 62 62 64 61 60 60 
71 72 71 71 70 70 69 68 67 68 67 66 64 62 62 62 58 55 54 59 54 65 58 65 59 65 61 61 55 55 62 58 62 60 54 55 61 54 60 54 
71 71 70 69 70 69 68 66 66 66 67 67 56 60 66 55 64 60 54 61 58 63 65 61 54 59 60 56 62 58 63 64 54 65 63 59 55 60 55 55 
70 71 70 69 69 69 67 66 65 66 64 58 65 58 59 56 60 60 57 59 58 64 56 62 63 64 61 63 66 64 63 61 59 62 56 54 65 55 55 62 
71 70 70 70 68 67 66 64 62 68 65 58 54 60 60 57 59 56 61 55 57 58 57 63 64 59 57 67 67 62 54 68 65 55 56 57 56 60 63 63 
70 70 69 69 68 65 59 56 63 66 58 60 54 58 63 55 58 61 62 62 60 55 64 64 58 59 59 68 68 65 62 61 56 61 61 62 59 63 63 57 
69 69 71 68 66 65 61 62 62 56 61 63 58 56 56 65 60 61 60 59 60 66 65 66 67 64 70 69 70 64 66 55 61 56 55 64 59 56 55 55 
70 66 66 64 57 56 63 63 56 61 65 65 58 63 61 61 57 54 54 62 58 64 68 67 67 69 66 69 70 66 61 59 56 63 61 56 62 56 55 55 
65 67 65 63 63 57 61 62 57 64 65 58 62 56 55 58 54 55 60 63 57 66 66 67 67 59 70 71 71 62 67 58 63 56 63 62 62 62 60 53 
59 65 63 56 66 64 58 60 59 59 63 62 61 53 53 53 52 53 51 64 54 57 62 64 65 59 58 65 63 56 55 65 62 56 63 60 66 58 61 57 
64 64 58 64 59 58 61 59 58 64 63 56 53 53 52 54 52 50 49 63 55 57 65 63 58 59 65 56 55 55 57 55 63 57 58 61 59 63 63 58 
65 63 62 57 62 62 60 64 63 63 62 53 53 51 53 52 54 49 47 63 59 60 64 63 54 65 64 61 53 52 59 66 64 67 64 58 57 64 63 57 
62 56 61 62 61 54 60 58 64 63 53 53 51 51 52 51 49 47 47 54 58 60 59 65 64 55 55 52 52 53 63 56 68 67 65 58 67 64 65 56 
54 61 62 57 60 60 58 63 56 57 53 51 52 50 50 49 48 48 45 64 54 65 56 57 55 61 53 60 52 51 54 66 66 67 58 68 64 63 58 66 
55 60 64 55 65 58 61 55 52 51 51 53 49 48 48 48 47 45 43 58 63 48 52 51 51 53 58 53 62 63 63 58 58 63 63 65 56 58 64 64 
56 60 55 60 65 62 56 51 51 51 51 51 48 48 48 46 46 43 43 53 53 51 51 50 50 60 54 57 64 65 57 64 57 57 64 63 64 58 63 63 
54 58 65 62 65 55 52 50 50 50 52 47 47 45 45 46 43 42 41 56 47 53 51 54 55 63 55 65 60 54 58 64 64 57 57 62 59 64 64 64 
63 57 60 55 52 51 50 51 49 49 48 49 46 45 44 44 43 42 41 46 51 46 53 53 63 58 61 61 55 54 57 58 63 57 57 63 56 57 64 66 
64 62 60 52 52 50 49 50 47 47 50 45 45 43 44 44 41 41 39 49 44 53 61 60 56 61 65 65 55 56 58 57 57 63 57 61 64 59 58 66 
56 61 57 64 60 55 58 65 65 65 65 56 65 58 64 56 64 53 55 62 51 52 52 52 52 53 52 56 62 56 57 58 55 62 57 64 67 66 66 67 
56 56 61 57 62 63 65 59 65 63 59 58 58 63 58 56 54 56 57 64 50 53 52 52 52 53 55 56 62 63 59 65 57 64 59 65 67 67 68 68 
55 56 59 64 57 59 58 59 58 60 63 61 58 58 54 62 56 58 64 59 53 50 52 51 61 53 62 57 58 58 65 65 59 66 59 68 66 67 59 59 
63 64 65 59 59 63 60 58 58 57 65 55 63 63 57 57 65 58 54 60 51 52 50 51 53 63 55 58 58 61 57 64 59 67 68 65 68 58 65 66 
64 64 65 65 65 54 58 65 65 57 55 64 64 58 57 65 65 59 61 57 52 50 52 50 54 54 57 59 59 57 63 66 67 67 67 69 59 66 64 66 
64 64 61 55 64 64 54 60 55 57 63 54 65 60 54 65 57 61 61 55 52 60 56 63 64 57 65 62 56 58 58 59 65 59 59 59 66 65 65 65 
56 63 62 62 56 60 65 56 55 58 58 65 54 54 55 60 60 55 55 61 61 55 58 58 59 64 54 56 57 58 65 59 65 59 65 57 66 59 66 66 
64 55 56 64 57 54 64 56 56 57 60 61 55 60 54 65 62 62 63 57 61 64 59 54 54 54 59 64 58 64 59 68 59 59 59 66 63 59 66 66 
61 61 62 57 55 56 62 57 57 61 61 62 61 61 54 55 60 63 63 58 64 59 60 54 61 57 63 58 58 66 65 59 65 59 65 64 67 67 67 66 
61 61 58 60 60 62 63 62 63 55 62 61 54 61 61 59 56 63 63 64 64 59 60 61 56 56 58 58 65 58 59 59 65 59 59 67 66 66 59 67 
56 57 63 59 55 55 62 60 54 54 60 56 65 65 65 60 65 63 55 61 65 59 65 63 57 59 63 62 55 61 59 59 66 66 66 66 66 66 66 66 
56 63 59 54 61 59 55 60 55 61 65 54 65 60 65 61 62 61 61 55 63 54 63 64 63 59 55 61 61 56 64 59 66 66 66 66 66 66 66 67 
58 58 62 62 61 62 58 60 61 55 55 62 59 59 56 61 59 55 61 62 60 61 64 64 55 59 56 56 57 58 65 68 66 66 66 66 67 67 67 68 
65 55 54 61 61 55 62 62 55 61 65 61 59 65 55 61 60 63 61 61 57 65 65 64 59 61 60 63 57 65 65 66 66 66 66 66 67 69 68 67 
54 65 56 56 56 62 54 55 56 55 61 64 65 59 60 60 62 61 62 54 59 57 58 63 59 59 62 64 64 64 66 66 66 66 66 67 67 67 67 67 
55 55 57 62 61 55 54 54 58 58 65 64 58 58 64 60 62 55 56 57 58 55 55 56 57 56 57 59 65 59 59 66 66 66 66 66 67 67 67 67 
56 62 62 56 62 54 60 58 58 64 63 65 64 64 59 55 61 57 63 57 59 61 63 57 58 56 64 65 59 65 59 66 66 66 66 66 67 67 67 68 
61 63 56 60 56 54 59 64 64 64 58 56 58 65 59 62 56 57 63 63 56 63 63 63 57 64 67 59 58 58 66 67 66 66 66 67 67 67 67 68 
57 60 62 54 58 59 58 65 58 64 56 58 64 59 61 56 63 63 63 57 58 59 58 58 57 59 58 57 64 65 59 67 66 66 66 66 68 68 68 68 
65 57 65 64 65 64 64 58 62 63 57 64 60 60 61 57 62 63 62 58 59 57 63 57 64 64 64 65 64 65 67 66 66 66 67 68 67 68 68 68 
54 60 65 58 64 58 64 57 57 57 64 59 60 61 62 63 57 64 63 58 64 64 64 63 58 58 64 59 59 59 66 66 67 66 67 68 68 68 68 69 
