17 16 17 14 15 15 11 14 12 11 10 11 08 09 10 10 11 12 13 14 14 17 15 14 14 17 12 22 17 15 14 15 12 14 15 15 15 17 17 17 
17 16 16 13 13 12 14 11 11 11 10 09 10 10 10 12 11 14 14 15 14 16 14 14 13 17 20 15 14 15 14 13 15 14 15 16 16 17 17 17 
16 16 11 11 16 12 13 11 10 09 10 08 10 10 11 12 16 15 15 14 17 14 14 12 21 15 18 14 14 13 14 14 14 14 16 16 19 17 17 17 
13 13 14 10 14 11 10 10 09 08 10 10 11 12 13 13 14 16 16 14 14 16 12 11 19 16 15 15 11 13 14 14 14 15 17 18 17 17 17 17 
17 14 15 11 08 08 09 09 08 11 11 08 11 12 12 14 17 17 19 21 18 18 13 13 13 10 14 11 10 16 16 11 15 15 16 16 19 20 22 23 
16 11 11 10 08 08 09 08 08 09 12 10 12 13 13 15 17 20 23 19 17 14 13 13 13 11 12 10 11 13 16 13 16 15 15 19 18 23 23 24 
12 13 07 07 10 10 09 08 07 12 09 13 14 16 17 18 18 23 24 15 15 14 13 12 12 14 10 10 09 16 11 19 17 19 20 20 25 25 25 25 
11 09 10 08 07 07 09 08 07 09 13 11 15 16 19 21 23 23 25 15 12 14 13 13 11 12 14 11 10 12 17 12 18 18 22 23 24 25 26 26 
09 11 07 07 07 09 07 07 07 12 09 15 17 18 20 22 23 26 27 13 14 13 12 12 12 15 10 09 08 14 11 18 19 19 21 24 25 25 26 28 
08 09 09 13 12 12 17 15 18 20 14 17 20 23 24 25 31 32 34 12 16 13 21 18 17 16 20 18 20 21 16 19 17 16 16 19 12 21 16 15 
08 11 10 13 14 16 15 20 20 21 18 18 24 26 27 29 31 35 35 12 15 20 17 19 18 17 18 21 22 23 17 17 16 15 14 16 20 15 15 16 
10 10 17 17 12 17 20 21 21 22 19 24 28 30 27 32 35 35 34 20 17 16 19 21 16 19 20 23 24 25 19 18 15 12 22 15 16 15 17 18 
11 16 15 19 19 20 23 22 23 22 25 27 30 32 34 35 36 35 35 16 18 17 21 20 20 21 24 25 26 25 16 17 13 12 14 14 12 18 15 18 
16 13 19 19 20 23 22 21 23 24 25 30 31 33 34 36 35 34 35 16 16 19 22 22 23 24 24 24 27 28 18 13 12 11 12 11 15 17 15 14 
16 17 16 19 21 22 22 24 25 26 29 27 33 33 34 35 36 37 38 18 19 31 26 27 28 24 19 23 19 18 14 15 14 14 14 13 17 15 14 14 
16 19 18 21 22 21 23 26 26 27 30 31 34 34 34 37 36 39 39 24 24 27 28 28 28 20 24 18 17 17 16 14 14 14 14 14 16 14 15 16 
18 17 22 23 22 23 25 27 29 30 29 36 35 36 37 36 42 41 42 20 32 28 26 21 19 20 18 16 16 16 15 16 14 13 13 17 13 15 14 14 
18 21 20 23 25 26 26 29 30 31 35 32 36 36 38 40 40 44 43 34 27 33 22 22 17 18 15 16 15 17 15 15 14 14 13 14 17 14 14 14 
21 19 23 25 25 25 28 30 31 32 31 36 37 37 38 39 42 41 44 29 36 23 21 19 19 15 15 17 15 14 15 14 13 13 14 18 13 14 14 14 
21 21 19 18 22 20 21 16 18 19 20 21 21 19 19 21 15 21 17 16 26 26 23 21 21 21 18 19 16 15 13 14 12 13 13 13 12 12 10 10 
20 19 20 19 21 19 17 19 20 20 21 22 19 18 17 18 21 16 17 18 24 24 21 20 19 19 20 15 15 14 15 12 13 12 12 11 13 10 11 12 
21 19 17 19 18 19 18 20 21 21 22 19 17 15 23 17 16 17 19 20 25 21 20 18 22 18 15 14 13 12 13 16 13 12 13 12 08 11 11 11 
18 18 18 19 19 20 22 22 23 21 18 19 16 15 15 17 15 20 18 21 21 21 18 17 16 14 13 12 12 14 12 13 13 12 11 09 11 11 11 12 
18 18 19 21 21 21 21 21 22 18 20 16 15 14 16 14 17 20 19 18 22 18 18 16 12 13 12 14 12 12 13 13 11 12 09 11 10 12 11 12 
18 18 21 23 21 22 20 23 22 17 16 22 18 19 20 16 17 17 15 15 18 20 15 14 14 12 13 12 11 12 11 08 09 09 09 10 13 12 14 15 
19 21 21 22 24 22 22 22 23 19 19 19 20 19 19 16 18 15 15 16 18 16 14 13 13 12 12 11 09 10 11 09 09 09 10 12 12 15 16 16 
19 21 25 23 23 21 23 23 24 16 21 21 19 17 16 18 16 15 14 14 18 15 13 10 10 13 12 09 07 11 08 10 10 12 13 14 14 16 17 17 
23 21 23 23 21 22 22 25 25 22 19 22 18 18 15 15 16 16 14 13 14 15 10 10 10 10 10 08 07 07 10 09 13 13 14 15 17 17 18 18 
22 23 22 21 22 21 24 25 24 19 23 18 16 17 16 17 14 14 13 12 16 11 11 11 10 11 08 07 06 09 08 12 13 14 14 17 17 17 19 19 
21 19 20 19 14 15 18 17 16 16 19 17 17 14 13 12 11 11 11 11 13 12 14 12 12 11 12 11 12 13 10 12 12 11 11 13 10 17 16 16 
20 20 17 18 16 15 18 16 17 17 16 18 13 13 12 12 11 11 12 12 13 14 12 12 12 11 11 13 13 13 11 12 11 11 10 13 15 16 15 15 
17 18 19 18 16 19 15 16 13 13 17 12 12 11 12 10 12 13 14 14 12 14 13 13 11 12 13 14 14 15 13 11 11 10 15 12 18 16 17 18 
19 20 20 22 19 15 18 13 13 13 13 12 11 10 10 11 11 13 14 16 12 11 13 12 12 13 14 14 15 16 11 13 11 11 13 15 13 18 17 19 
18 20 20 19 17 19 13 14 12 12 13 10 12 10 11 10 13 14 15 16 11 12 13 12 12 13 14 15 15 17 13 11 11 10 14 12 17 17 18 17 
20 18 14 12 15 14 15 11 11 12 11 16 13 14 14 12 12 14 12 12 11 15 13 13 14 14 13 16 15 15 12 14 15 16 16 16 17 18 18 18 
17 16 14 12 10 13 13 12 13 14 13 13 14 14 14 12 15 12 14 15 13 14 14 14 15 15 15 15 15 15 14 14 16 16 16 15 18 18 19 19 
17 12 11 12 10 14 10 13 13 13 16 14 14 13 13 13 10 13 13 13 15 14 14 14 14 14 17 16 16 16 15 19 17 17 18 18 17 19 19 19 
11 11 09 10 12 12 14 13 13 13 13 17 15 14 11 12 13 12 13 15 14 17 15 15 13 14 14 15 15 17 17 17 19 18 17 17 19 19 19 20 
10 09 11 12 11 14 12 13 14 14 18 14 12 13 13 13 12 15 14 14 17 14 14 14 14 13 15 16 15 16 17 18 16 17 17 19 18 20 20 20 
10 10 11 12 12 13 13 14 13 14 15 14 14 11 12 13 13 14 15 15 16 15 15 13 14 14 15 16 17 17 17 18 17 17 18 19 19 20 20 21 
