73 73 73 72 73 73 71 73 73 74 75 73 77 77 78 76 82 77 80 81 80 82 80 79 79 81 78 83 80 79 79 77 78 77 77 76 75 74 74 74 
73 72 73 72 72 73 72 74 73 73 74 75 78 78 80 79 77 81 81 81 81 80 79 79 78 81 83 79 79 78 79 78 77 76 76 76 74 74 75 76 
73 73 72 71 73 71 75 74 75 76 74 80 80 81 75 80 82 82 80 80 82 80 79 78 83 80 80 79 79 79 77 80 76 75 75 74 73 76 76 77 
72 73 72 71 74 73 72 75 76 78 76 77 82 83 78 80 82 80 82 80 80 81 78 77 81 81 80 79 77 79 78 76 75 74 74 74 75 77 78 79 
73 72 73 74 70 72 74 77 77 73 76 78 83 81 81 85 82 82 80 84 82 80 78 78 78 77 80 78 78 76 75 77 74 74 74 75 76 77 76 76 
73 72 71 73 76 74 76 78 79 75 78 82 81 82 83 82 82 80 81 82 81 78 78 77 77 79 79 79 79 76 75 75 74 76 77 75 78 76 79 80 
71 72 76 75 76 76 79 79 80 79 81 82 82 81 81 81 81 81 82 80 78 79 78 78 78 80 79 79 77 75 77 73 76 75 75 77 75 79 79 80 
73 74 74 76 76 79 79 80 80 81 81 82 81 81 82 81 80 84 83 78 78 77 78 78 78 79 80 77 78 76 74 77 75 76 76 76 79 79 80 81 
74 74 76 75 78 78 79 80 80 81 82 81 82 80 81 79 82 82 84 76 77 78 78 77 78 81 78 79 77 75 77 75 76 77 77 78 78 81 80 81 
74 73 75 72 73 75 73 77 76 76 81 81 82 83 83 83 84 83 84 77 79 76 82 80 80 78 82 78 79 80 74 76 73 73 73 75 71 77 74 73 
74 73 74 73 73 74 77 76 76 77 82 81 83 83 83 83 84 84 85 76 77 81 80 81 81 79 78 80 80 81 75 74 73 73 72 72 76 73 73 73 
73 75 70 71 77 75 76 77 77 77 81 85 84 84 83 84 83 85 85 81 78 81 81 82 77 81 80 81 79 79 76 72 72 70 77 73 74 72 71 71 
74 73 74 72 75 74 75 76 76 79 84 83 85 85 84 83 86 84 86 78 79 78 80 81 81 80 82 79 80 80 72 74 69 70 72 72 70 70 70 73 
74 75 71 73 74 74 76 78 76 78 83 85 84 85 84 86 85 87 87 78 77 81 83 83 79 83 80 80 81 82 75 70 71 71 71 70 71 73 71 70 
73 73 73 73 74 75 78 78 78 79 84 84 85 85 86 85 86 87 87 79 79 87 82 82 82 80 76 78 74 73 71 71 71 71 71 70 73 71 71 71 
73 73 73 73 74 77 78 79 81 82 85 84 86 85 85 86 87 88 90 83 81 83 82 82 82 77 79 73 73 73 73 71 71 70 70 71 71 71 71 71 
73 73 73 75 76 79 76 81 81 82 84 88 86 87 87 87 85 90 91 79 87 82 81 77 76 76 73 72 73 73 71 74 71 70 70 72 72 71 69 69 
73 74 75 77 78 79 82 80 82 84 86 85 88 87 87 88 90 91 92 87 81 86 79 78 74 72 72 74 72 73 71 70 71 70 70 70 72 70 70 69 
74 74 76 78 79 82 80 83 82 85 85 87 86 87 88 90 90 92 93 82 88 79 76 75 74 72 72 73 71 70 70 71 70 70 70 73 70 69 68 69 
75 75 74 73 76 75 81 76 79 80 81 80 83 82 82 81 82 81 81 81 80 79 79 80 81 79 82 77 79 80 80 77 81 78 78 75 76 71 72 73 
74 73 75 76 78 76 77 80 81 80 81 82 82 82 82 81 81 81 81 81 81 78 81 80 81 81 78 80 80 78 79 80 78 76 77 75 72 73 73 74 
75 74 73 77 75 80 78 81 80 82 81 84 82 82 81 81 83 81 80 80 78 84 81 82 78 81 79 80 78 81 77 81 77 77 73 74 73 74 74 74 
74 76 78 81 81 80 84 80 82 81 81 81 83 82 82 81 81 81 80 80 82 80 84 83 81 79 82 79 80 77 78 74 77 75 74 73 75 74 75 75 
77 77 79 82 80 84 81 81 82 80 80 82 82 82 80 81 80 80 79 80 79 83 81 84 79 82 79 79 78 77 74 76 76 74 74 75 74 74 75 76 
78 78 78 78 81 81 81 83 84 81 80 86 81 81 81 80 77 77 74 74 80 78 79 78 78 80 80 80 80 76 75 81 76 76 76 74 71 73 70 70 
78 77 79 79 79 82 82 84 85 83 81 83 81 80 80 77 78 74 74 74 79 79 78 78 78 80 80 80 81 78 76 77 76 76 76 72 74 70 70 70 
79 78 78 80 81 82 84 85 87 80 85 81 79 76 75 77 74 73 71 71 77 79 78 79 80 80 80 82 83 75 80 75 75 72 71 71 70 69 69 69 
78 79 80 82 83 84 84 87 87 85 80 83 77 76 73 72 72 71 70 71 79 77 80 79 80 80 81 83 83 80 76 79 74 73 69 69 68 69 68 70 
79 79 81 82 83 83 86 87 88 80 85 77 75 74 73 73 71 72 71 69 76 79 79 80 80 81 82 83 85 77 81 73 71 71 70 68 68 70 69 68 
80 79 79 77 76 76 75 77 75 75 78 76 75 75 75 73 74 71 72 72 77 77 75 74 74 74 68 73 70 69 74 74 70 69 69 68 67 66 64 64 
79 78 77 76 75 77 77 75 73 73 75 76 75 73 74 74 71 72 70 70 77 75 74 71 71 71 72 69 67 67 72 72 69 69 68 67 67 64 65 66 
78 78 76 75 77 75 76 73 72 72 75 75 73 72 72 72 75 71 70 70 76 76 71 68 75 69 74 68 68 69 72 67 68 68 68 67 57 59 59 59 
78 74 76 75 75 74 72 71 71 73 74 73 71 72 73 71 71 71 70 69 73 72 70 68 68 70 59 69 67 69 68 70 69 68 65 57 65 59 59 66 
74 77 74 74 74 72 72 73 70 71 73 72 73 71 71 71 71 69 70 69 73 70 67 66 68 58 68 68 67 66 70 67 67 66 64 59 64 66 59 66 
74 73 73 70 72 71 73 70 69 69 72 73 70 70 70 69 68 69 68 68 70 70 67 66 66 67 69 67 66 66 67 67 59 59 65 58 59 64 64 58 
73 72 72 70 69 72 72 69 70 71 71 71 70 70 70 69 68 68 66 66 68 69 66 67 68 68 68 66 66 67 59 65 59 64 64 58 65 64 65 66 
73 73 68 69 71 72 68 70 70 70 72 70 69 68 68 68 70 67 67 67 69 64 66 59 59 68 67 66 59 59 66 59 58 64 64 66 62 65 59 65 
71 69 71 70 70 70 72 71 70 69 69 70 69 68 67 68 67 68 67 66 66 68 59 66 66 66 67 66 65 58 64 59 64 64 64 64 66 65 65 66 
68 71 69 70 70 72 69 70 70 69 71 68 68 66 67 67 67 66 67 66 68 59 67 67 66 68 65 65 65 58 65 64 58 57 58 66 64 66 65 66 
69 70 70 70 70 71 70 70 69 69 69 68 68 67 67 67 67 66 66 66 67 66 67 66 66 66 65 59 64 64 58 64 64 58 58 65 59 66 66 66 
