38 32 32 39 38 32 31 33 38 38 38 38 33 38 38 32 31 37 29 29 29 25 27 24 23 21 22 19 20 21 19 25 19 20 21 25 20 28 22 21 
38 32 38 33 37 32 32 32 38 38 33 39 32 32 37 36 37 29 29 27 27 28 23 23 22 20 19 21 20 23 21 20 21 21 20 22 28 21 21 21 
32 38 40 38 32 31 35 39 33 33 32 33 31 37 38 31 30 29 28 36 26 24 23 23 19 20 23 21 20 18 23 21 21 19 29 24 20 19 19 19 
39 37 31 37 33 39 32 40 34 33 38 38 37 36 31 29 30 28 28 27 26 24 24 22 21 20 20 20 21 19 22 23 19 19 24 22 22 19 14 13 
32 37 32 37 30 31 38 40 40 38 31 35 38 37 31 29 27 26 24 22 22 27 22 21 21 22 17 19 16 29 26 20 19 18 18 17 22 16 17 18 
38 32 31 31 32 38 33 34 41 33 38 32 37 30 36 28 27 23 22 24 23 24 21 22 22 19 19 15 14 24 23 19 18 15 15 19 17 18 18 18 
37 37 31 37 33 33 34 41 30 37 34 33 29 26 25 27 24 22 20 22 27 19 20 17 16 17 16 14 13 24 17 21 16 17 17 21 17 17 16 16 
37 38 39 40 33 41 30 32 31 41 36 38 27 26 24 23 22 21 20 26 21 25 18 18 15 15 12 13 12 16 17 13 17 16 18 18 21 18 17 14 
32 32 33 39 40 41 36 30 37 29 33 27 26 24 24 23 21 21 20 22 27 18 17 16 15 12 13 13 12 14 12 17 17 17 17 22 17 15 16 16 
32 32 31 28 33 38 25 27 24 24 27 26 22 19 19 18 14 16 13 21 18 19 15 17 18 17 20 16 16 17 17 15 19 17 16 15 15 16 18 19 
31 36 38 27 29 28 27 24 22 21 25 24 19 17 16 15 16 13 11 20 18 15 18 18 19 17 17 17 17 17 17 19 16 16 15 17 15 19 19 20 
32 37 26 25 31 24 28 22 23 24 24 19 16 14 18 13 15 11 12 16 17 18 18 18 16 19 15 16 14 14 17 17 16 15 15 15 21 21 23 24 
29 24 25 21 23 25 20 25 22 23 17 18 17 14 12 14 10 14 11 17 16 18 17 19 19 16 19 16 15 13 14 14 14 14 16 20 19 23 24 26 
23 26 21 22 23 19 23 22 23 20 19 15 14 13 12 09 12 11 11 17 18 18 19 19 17 20 15 14 14 14 14 14 17 15 19 18 23 24 25 28 
23 23 28 25 23 22 21 20 17 17 15 16 13 11 11 11 11 09 07 17 16 10 13 11 11 15 17 15 17 18 15 23 21 22 23 22 20 26 24 24 
25 24 25 25 23 22 21 17 15 15 14 14 11 11 11 10 10 07 07 13 14 13 11 11 11 15 15 18 18 19 20 21 23 25 26 22 25 24 25 25 
23 28 22 20 24 20 18 15 12 12 15 12 10 07 07 10 08 06 05 16 09 13 12 13 14 16 17 19 19 19 24 22 25 23 23 23 24 25 26 27 
28 20 25 20 16 15 15 12 11 12 09 12 07 07 07 06 07 07 05 08 12 08 12 13 17 18 19 18 20 21 23 28 24 25 23 24 23 26 26 28 
22 27 18 16 16 16 12 13 12 10 13 08 08 07 07 08 05 05 03 10 06 13 15 14 16 19 19 20 21 23 29 24 24 24 25 22 25 27 27 27 
20 19 21 22 17 19 17 21 18 17 15 15 12 14 15 14 18 13 15 16 12 13 14 14 14 15 15 17 17 17 18 19 22 22 22 23 23 26 26 26 
20 20 19 20 17 18 21 17 16 16 14 12 15 15 16 15 14 16 16 17 13 14 14 14 14 15 17 17 19 18 18 21 22 22 22 25 25 26 26 27 
18 20 23 20 21 19 17 15 13 13 13 16 17 18 13 17 15 16 14 14 14 16 15 15 17 16 16 19 20 20 21 22 23 24 25 25 27 27 26 26 
21 21 20 19 18 15 14 13 12 14 15 16 19 19 18 16 19 15 16 14 14 15 15 15 16 16 18 19 20 21 22 23 25 24 25 26 25 25 26 28 
20 21 19 17 16 15 13 14 11 16 15 18 18 21 16 19 15 15 15 16 15 15 15 15 18 17 19 22 22 21 22 23 24 24 24 25 26 28 27 28 
20 18 17 15 14 12 14 09 08 16 16 10 13 12 12 16 17 16 17 18 14 16 17 19 20 19 21 23 24 22 22 26 26 27 27 26 26 28 27 27 
18 17 15 13 12 10 11 08 08 13 12 13 12 12 13 16 16 18 20 21 15 16 20 20 20 20 23 25 26 24 24 25 27 27 28 26 27 27 27 27 
17 16 14 12 11 13 07 07 05 16 10 12 13 16 17 17 16 21 22 23 17 20 21 22 22 23 24 27 27 23 27 28 28 27 27 27 28 27 27 27 
15 13 11 09 08 07 10 06 06 09 11 09 15 15 19 19 21 22 23 25 19 20 22 22 23 24 26 27 28 28 27 29 29 28 26 27 27 27 27 27 
11 12 09 08 08 11 06 06 05 10 08 14 17 18 18 20 21 23 26 26 20 21 22 23 24 26 27 28 29 26 29 28 27 27 27 27 27 27 27 27 
11 13 11 14 22 19 20 14 16 17 11 15 14 15 16 19 19 25 23 23 21 21 24 25 25 25 27 27 27 27 26 27 26 26 27 27 28 27 27 27 
11 14 16 16 21 17 15 17 18 18 13 14 16 17 17 20 23 23 22 22 21 23 25 25 26 25 27 27 27 27 26 26 27 27 27 26 27 27 27 27 
16 13 18 19 16 17 15 18 19 20 15 15 18 18 22 22 25 22 21 21 22 27 26 26 26 28 27 27 26 26 26 27 27 27 27 28 29 27 25 24 
14 16 14 16 16 18 19 19 21 21 17 19 18 19 22 22 21 21 20 22 26 25 26 27 28 26 28 25 26 27 27 27 27 27 28 28 27 24 25 25 
15 13 17 19 18 19 19 20 21 24 19 18 19 21 21 21 21 22 20 20 24 27 27 27 27 28 26 27 25 27 27 27 27 28 27 27 26 26 24 25 
15 16 24 24 19 20 16 21 18 18 18 17 19 19 19 20 23 20 21 21 26 28 26 27 27 26 26 26 25 25 27 26 27 26 26 26 26 24 24 24 
19 20 21 24 25 20 20 18 18 18 19 19 19 19 19 20 21 21 22 23 25 27 27 26 26 24 26 25 25 25 27 26 26 24 24 24 25 24 24 24 
17 25 25 21 25 18 19 18 19 19 18 19 19 20 20 23 18 22 22 22 28 27 26 24 24 26 25 25 25 25 26 29 25 24 24 25 22 23 23 23 
27 21 26 21 17 18 16 20 18 19 18 18 20 20 21 20 24 22 23 23 24 27 24 24 24 24 25 26 25 25 27 25 25 24 24 23 24 23 23 24 
21 27 20 17 19 15 18 19 18 17 18 19 20 21 20 24 21 23 22 24 27 24 25 25 24 25 25 25 25 25 25 25 24 23 23 24 22 24 23 24 
21 22 19 17 17 17 18 17 18 18 19 20 20 21 21 23 23 24 23 24 25 24 25 24 24 25 25 25 25 25 24 24 23 23 23 23 23 24 24 24 
