15 15 15 15 15 15 16 16 15 15 13 15 12 12 12 13 11 14 13 13 13 14 15 16 17 17 19 17 18 19 19 20 21 20 20 20 17 20 17 17 
15 14 15 15 15 15 16 15 14 15 14 12 12 11 11 13 13 13 12 13 15 14 17 17 18 17 18 19 20 19 21 21 20 19 18 18 20 17 18 19 
15 15 15 15 16 16 17 14 12 12 13 14 12 10 14 12 15 12 12 14 14 19 18 19 17 19 16 20 20 20 20 22 19 17 21 18 17 18 20 21 
15 15 16 17 16 14 15 12 10 13 12 12 10 10 14 13 12 13 12 16 16 16 19 20 16 17 21 20 21 21 19 19 17 15 19 18 18 21 21 21 
16 16 15 14 17 15 14 12 11 15 13 10 10 10 10 10 14 14 16 15 16 16 19 19 19 22 22 21 21 21 19 23 18 19 19 16 18 20 20 20 
15 14 16 14 13 14 12 11 09 12 11 10 10 10 10 13 13 17 17 15 17 19 19 20 20 21 22 22 23 22 21 19 19 19 20 17 20 20 20 20 
16 15 14 13 12 12 15 09 08 12 09 11 11 13 14 14 17 18 18 18 18 19 20 21 22 22 20 23 23 18 22 19 20 18 18 19 20 20 20 20 
15 13 12 10 11 10 09 09 08 08 11 09 13 13 15 16 18 18 19 18 20 19 22 21 22 21 23 23 24 22 19 22 19 19 18 18 20 21 20 19 
12 13 11 11 09 09 09 07 08 11 08 12 13 14 15 18 18 18 20 19 19 20 21 21 21 22 23 24 24 20 23 19 18 18 19 20 20 19 18 19 
12 12 11 12 15 14 19 15 17 18 12 13 15 16 17 18 22 22 23 20 20 19 18 16 16 16 15 18 17 17 19 19 19 17 17 17 15 18 17 17 
11 13 13 13 17 16 15 18 17 17 14 14 17 18 19 20 21 24 23 19 19 20 16 17 15 16 17 17 17 17 19 19 17 16 16 17 17 17 16 16 
13 12 14 16 13 18 20 18 16 16 14 17 20 22 19 23 25 23 21 20 19 14 16 16 17 16 20 18 18 18 19 21 17 16 18 15 20 17 16 16 
12 14 15 19 19 18 20 17 18 16 19 19 22 23 24 22 24 22 22 18 16 18 18 17 16 19 16 18 18 19 18 17 18 16 16 16 14 15 15 17 
14 14 18 20 18 21 18 16 16 18 18 21 22 24 22 25 22 21 22 16 18 16 17 16 18 16 18 18 17 18 17 17 15 15 15 13 16 17 16 16 
15 15 17 18 18 18 16 16 16 16 20 19 19 18 18 21 22 22 22 16 16 19 19 19 20 18 17 17 16 16 16 18 16 16 16 15 16 16 16 16 
16 17 17 17 18 15 17 16 15 15 19 20 18 19 20 23 21 22 21 17 18 18 20 18 18 18 18 16 16 16 17 16 16 16 16 15 16 16 16 16 
16 17 20 18 17 16 15 15 16 17 20 16 19 19 20 21 26 23 21 17 20 22 19 17 17 17 16 16 16 16 17 17 16 16 16 16 16 16 15 15 
18 16 17 16 15 15 15 17 16 17 16 19 19 19 21 21 21 21 21 21 19 20 19 18 16 16 16 17 16 16 17 17 17 16 15 15 16 16 15 15 
16 17 16 15 15 14 15 16 16 16 19 18 20 19 20 21 22 22 22 20 21 19 17 17 16 16 16 16 17 16 17 16 15 14 15 16 15 15 16 15 
16 16 16 15 16 16 14 15 14 14 14 15 15 16 16 16 19 19 19 19 18 18 18 19 20 19 23 20 19 19 18 18 16 16 16 15 13 14 12 12 
16 14 16 15 15 15 15 14 14 14 14 15 16 17 17 19 19 19 19 19 18 18 20 20 21 19 20 19 19 18 18 17 16 14 14 13 14 12 12 12 
16 16 15 14 16 14 12 14 15 14 15 16 18 18 17 20 22 19 17 16 18 20 21 22 19 22 21 19 16 17 17 17 14 11 15 12 13 12 13 13 
15 13 14 14 13 13 14 16 15 15 16 17 17 19 21 18 20 17 17 16 21 20 21 22 23 20 21 16 16 17 14 14 11 11 12 13 11 13 13 14 
13 14 13 13 13 13 14 15 16 17 17 18 20 20 19 20 18 17 17 16 19 21 23 23 21 22 17 16 15 15 14 12 12 10 12 11 13 13 14 13 
13 13 15 15 13 13 14 15 15 17 17 16 16 16 16 17 17 16 16 16 20 19 17 15 15 18 17 15 15 13 12 13 12 12 13 12 13 13 13 13 
14 15 14 16 16 15 15 15 15 16 16 17 16 15 15 16 16 16 15 15 19 19 15 15 16 18 16 15 15 13 13 12 13 12 12 12 13 13 14 14 
13 15 16 15 16 15 17 16 15 17 16 15 15 14 14 16 18 15 15 15 18 13 14 15 15 16 15 14 14 12 13 14 13 12 12 14 11 13 13 13 
15 15 15 14 14 15 15 15 15 16 15 15 13 14 15 16 15 17 15 14 14 16 16 15 15 15 15 14 14 13 12 13 13 13 12 12 14 13 14 14 
13 15 14 14 15 15 15 16 14 14 15 14 15 15 15 15 15 14 15 14 16 14 15 14 14 15 14 14 14 13 13 13 12 12 13 14 13 14 15 15 
14 14 14 16 16 15 19 15 15 16 14 14 15 16 17 16 19 15 15 15 14 13 14 13 13 12 13 12 12 13 12 12 13 13 14 14 14 14 13 13 
14 16 15 17 17 14 16 16 17 17 16 14 17 16 18 16 16 15 15 16 13 14 13 13 13 12 12 13 12 12 11 12 14 13 14 14 14 13 13 14 
15 14 19 19 15 19 13 16 15 15 14 19 17 18 15 18 16 15 13 13 14 13 13 13 12 12 13 13 12 12 12 14 14 14 14 14 12 13 12 12 
15 18 17 18 18 16 19 16 16 14 17 16 20 19 18 15 17 13 14 13 13 13 14 13 12 11 12 12 12 13 12 13 14 14 14 12 13 12 12 13 
18 16 19 20 17 20 15 15 14 16 15 19 18 19 16 18 14 14 12 14 13 13 13 12 12 12 12 13 14 13 13 14 14 14 12 13 12 13 12 13 
18 17 18 16 16 15 14 13 11 11 16 16 15 14 14 14 13 13 12 12 12 15 11 10 10 11 11 12 11 11 12 13 11 11 11 12 13 12 12 12 
18 17 17 15 14 13 14 11 12 12 17 15 14 13 13 14 13 12 11 11 11 13 10 11 12 11 12 11 11 11 11 12 11 12 12 13 13 12 12 13 
17 17 15 14 14 14 10 11 11 11 15 15 13 12 12 13 14 12 10 10 15 08 11 10 10 11 11 10 10 10 13 10 12 11 11 13 12 12 13 13 
17 14 14 13 11 10 12 10 11 12 13 13 13 12 12 13 11 10 10 11 11 14 12 11 09 10 10 09 09 11 09 12 11 11 12 11 13 14 13 13 
13 15 12 11 11 12 10 12 11 12 13 12 12 12 11 11 11 11 10 11 15 10 10 10 10 10 09 11 09 10 12 10 12 11 12 13 12 13 12 13 
13 12 11 10 10 11 11 12 12 12 12 12 12 11 11 10 10 11 11 11 12 11 11 09 09 09 09 10 10 10 11 11 12 12 12 13 13 13 13 13 
