45 44 44 43 44 44 43 44 44 44 44 43 43 44 44 43 47 43 44 45 44 46 45 46 47 48 49 51 50 50 50 48 49 47 46 45 45 43 44 45 
44 43 44 43 43 45 43 44 43 43 43 43 44 45 45 44 44 45 46 45 45 45 47 48 48 49 50 50 50 49 48 49 46 46 45 43 43 45 46 46 
44 44 42 42 44 43 46 44 44 44 43 44 46 47 43 47 44 46 46 44 46 46 48 49 49 50 52 50 49 50 48 47 46 45 44 44 44 46 47 47 
43 43 43 41 45 43 43 44 43 44 44 45 48 49 43 45 48 46 47 45 46 48 50 51 50 51 51 49 48 48 46 47 45 45 44 44 45 47 49 50 
44 43 43 42 42 42 43 43 43 43 45 44 47 44 43 50 48 47 46 48 49 45 49 47 47 51 52 49 49 46 45 49 47 48 48 46 45 48 47 47 
43 41 42 42 42 41 43 43 43 43 44 47 43 45 46 48 48 46 47 46 47 48 47 47 47 49 50 49 50 47 47 47 48 48 48 45 48 47 48 48 
43 43 41 41 43 43 43 43 43 47 46 42 45 46 47 47 45 47 48 50 46 49 47 48 48 51 48 50 50 45 49 51 49 46 46 47 46 48 49 50 
42 40 42 42 42 43 44 44 44 44 43 45 47 46 47 46 47 48 48 46 47 45 48 47 49 49 51 49 50 50 48 50 46 47 46 47 47 50 49 50 
40 42 41 42 43 44 43 44 44 43 45 45 46 47 45 46 47 49 50 46 44 47 48 48 48 51 49 51 51 49 50 48 47 46 47 47 48 49 49 49 
41 41 41 39 42 42 44 44 44 44 44 45 46 48 49 49 60 53 54 46 47 46 49 46 45 45 42 45 43 43 47 48 44 43 43 44 41 45 42 42 
41 39 41 42 43 42 44 44 45 45 44 46 49 50 51 53 52 61 54 46 46 49 45 45 43 43 45 43 44 45 45 46 43 43 42 43 45 42 42 42 
41 41 38 41 43 44 45 45 45 45 46 48 51 53 50 54 56 55 53 49 48 46 44 42 46 42 45 45 46 47 47 41 42 41 46 42 42 42 43 44 
40 41 43 45 45 44 45 45 45 46 50 50 53 60 56 54 56 54 60 47 44 44 43 42 42 44 42 46 46 49 42 45 43 42 41 41 40 44 42 44 
42 43 43 44 44 45 45 45 45 46 49 52 54 56 54 57 60 53 54 45 45 43 43 41 42 41 45 48 48 48 46 41 41 41 41 40 42 43 42 41 
42 42 42 41 44 44 46 47 47 48 51 50 52 52 52 54 54 61 62 43 43 51 47 48 49 45 44 47 44 44 41 42 41 41 42 41 43 43 43 43 
42 42 43 44 43 45 46 48 48 49 50 52 52 52 53 55 54 62 56 47 48 47 49 48 48 46 47 44 44 44 42 41 42 41 41 41 42 43 43 43 
43 43 41 43 45 46 48 49 49 50 51 52 53 54 61 54 64 57 63 43 51 51 48 44 43 45 47 44 42 42 41 43 42 42 42 43 45 43 43 43 
42 43 44 45 47 47 49 50 50 50 52 52 61 54 61 62 56 59 58 53 48 52 45 45 42 44 42 42 41 43 41 42 42 42 42 44 44 44 43 42 
43 44 44 46 47 48 49 50 50 51 51 53 54 55 55 62 64 57 63 50 53 46 44 43 44 42 42 43 41 41 42 42 42 42 42 44 43 42 42 42 
44 44 43 44 45 44 43 42 43 44 45 45 47 47 47 47 48 47 46 46 47 47 47 48 48 47 52 47 48 49 49 47 48 46 46 45 47 44 45 46 
43 44 44 43 44 43 42 44 44 44 45 47 47 47 47 46 48 46 47 48 48 46 48 49 50 49 48 49 49 48 47 49 46 47 46 45 44 46 46 47 
44 43 45 44 43 42 45 45 45 46 46 46 47 48 47 48 45 47 47 47 46 50 50 51 46 51 49 50 48 50 47 45 47 47 44 46 48 47 47 48 
43 42 41 42 42 44 43 45 46 46 45 47 48 48 48 47 48 47 47 47 49 49 52 52 51 50 52 49 49 46 45 45 45 46 47 48 49 49 49 47 
41 41 42 42 43 42 45 46 47 47 46 47 49 49 47 48 46 47 47 47 48 51 52 52 49 53 49 48 49 45 45 45 49 47 49 49 48 47 48 49 
41 41 43 41 44 45 45 47 47 46 46 50 47 47 47 47 45 46 45 45 49 47 48 47 47 49 49 48 48 45 45 49 47 46 46 48 45 46 43 43 
42 42 43 42 43 45 47 47 49 48 47 48 47 47 47 46 46 45 43 43 48 48 47 47 47 47 49 48 49 47 44 48 46 47 48 46 47 43 44 44 
42 44 40 43 47 47 44 49 50 46 50 47 47 44 44 45 48 43 42 42 47 48 48 48 49 49 46 49 51 46 50 43 46 43 43 45 42 43 44 45 
43 43 46 45 47 48 48 49 50 50 45 49 44 44 44 45 43 43 42 41 48 46 48 48 50 49 50 52 52 49 43 49 43 44 43 42 43 45 44 45 
44 46 44 46 47 48 48 52 52 46 50 44 45 44 44 43 43 42 41 40 46 48 49 49 49 50 50 51 53 46 50 43 45 43 43 43 43 44 44 43 
44 43 44 44 41 42 41 43 42 42 44 43 43 44 44 43 46 42 43 43 46 46 45 45 46 45 48 45 44 44 43 44 43 42 42 42 41 42 40 40 
44 43 42 44 41 41 43 42 42 42 45 43 44 44 45 44 43 43 43 43 45 45 46 46 47 45 46 44 45 45 43 43 42 42 41 42 42 40 41 42 
42 43 45 43 43 42 42 41 41 41 43 44 45 45 42 45 44 43 42 42 45 44 47 47 45 48 44 44 42 42 43 42 42 40 43 42 39 41 41 42 
43 43 42 42 42 41 41 41 40 41 44 43 45 45 45 43 45 43 43 41 45 46 47 48 47 44 47 43 43 41 42 42 40 40 41 41 41 40 41 44 
43 42 42 41 39 41 40 41 41 40 43 44 46 45 43 46 43 42 41 42 46 47 48 49 45 48 43 42 42 42 42 40 41 39 41 41 40 43 42 43 
42 41 40 41 40 40 41 40 40 40 43 44 43 42 42 42 41 41 41 41 45 44 44 43 43 43 43 42 42 43 41 42 41 41 41 41 42 42 42 42 
41 40 40 40 41 41 40 40 41 41 42 43 42 42 42 41 41 41 40 40 45 44 43 41 41 44 42 43 41 41 41 41 41 41 41 42 43 42 43 44 
41 40 43 41 40 41 41 41 41 41 43 42 41 41 41 41 42 40 40 40 44 46 42 42 42 42 45 41 39 39 42 42 41 40 40 43 41 43 42 42 
40 41 39 41 40 40 42 43 42 40 41 42 42 41 40 41 40 40 40 41 42 42 43 41 41 42 40 39 39 40 40 41 39 40 41 41 43 41 42 44 
41 39 40 40 40 42 41 40 40 41 42 41 41 40 40 40 40 40 39 40 42 42 41 40 40 40 40 40 39 40 41 40 41 41 41 43 41 44 43 44 
40 39 40 40 41 42 42 41 40 41 41 41 41 40 40 40 40 40 41 41 41 41 40 40 40 39 39 40 40 40 40 40 41 41 41 42 42 44 44 45 
