53 52 52 49 51 50 48 48 47 47 47 47 47 46 46 46 49 47 47 47 46 44 45 43 43 41 40 39 40 41 42 41 44 44 44 43 46 44 45 45 
52 52 51 49 49 49 49 47 47 47 45 47 46 48 47 46 48 47 47 45 44 45 43 41 41 42 39 41 41 41 41 44 44 45 45 43 44 45 45 46 
52 51 47 47 50 47 47 47 48 47 47 45 48 49 46 49 47 47 45 46 44 46 42 40 40 39 41 42 44 44 43 44 45 45 43 45 45 45 44 44 
49 50 49 48 48 46 47 48 48 46 47 48 49 51 46 46 49 44 44 46 44 42 40 38 40 41 40 45 46 44 44 44 46 46 44 46 46 44 45 46 
51 49 50 48 45 46 47 48 48 47 48 48 49 46 45 50 48 44 43 42 41 43 40 42 43 40 41 45 44 42 43 47 46 44 44 47 44 44 42 42 
50 49 47 47 48 46 48 49 49 47 46 50 45 46 47 47 46 43 41 42 43 40 43 43 43 41 45 44 47 44 44 47 44 45 46 44 45 42 41 41 
48 49 47 46 49 48 49 49 49 50 49 44 45 43 43 45 43 41 41 40 42 44 44 43 43 44 42 47 49 45 49 42 44 43 43 44 42 41 40 40 
48 47 48 47 47 47 49 51 50 48 43 46 43 43 44 42 42 42 41 43 42 44 42 43 44 45 47 48 49 48 43 48 44 43 42 42 40 40 39 40 
46 48 47 46 48 49 49 49 49 44 46 43 45 43 42 42 41 40 40 42 44 43 43 44 45 46 47 51 51 44 49 42 43 41 41 40 39 40 39 39 
47 47 46 45 47 46 42 43 42 42 42 42 41 42 42 41 44 41 41 42 40 42 38 38 38 39 36 41 38 38 44 42 44 42 41 40 39 39 40 40 
46 45 46 44 44 44 42 42 40 40 41 41 42 42 43 43 41 41 39 42 41 39 38 37 37 39 40 38 36 36 42 43 41 40 40 40 39 40 40 41 
47 46 44 43 45 41 45 41 41 41 41 43 43 44 40 43 43 39 37 39 41 39 37 36 41 37 41 37 37 37 42 45 41 39 40 38 41 42 43 43 
45 43 42 40 41 41 39 42 41 41 42 42 45 44 43 40 41 38 37 41 38 40 38 37 37 38 35 38 36 37 43 40 40 39 38 42 40 42 43 45 
42 42 40 40 40 39 42 41 41 40 42 43 43 44 40 42 38 36 36 38 40 37 35 35 35 34 37 36 36 34 40 40 39 39 41 39 42 43 43 45 
41 40 44 40 40 40 39 39 37 37 41 40 38 36 36 37 36 33 32 38 37 34 35 34 34 35 39 37 38 39 41 43 41 41 42 42 42 45 45 45 
42 39 42 41 39 38 40 37 37 37 39 39 36 35 35 35 35 32 32 36 36 35 34 34 34 38 37 39 39 39 41 42 42 43 44 42 44 45 45 46 
40 44 37 37 41 39 38 36 35 35 39 35 34 33 33 35 31 31 31 37 33 35 35 37 38 38 40 40 38 38 43 39 42 42 42 44 45 46 46 47 
43 38 42 37 36 35 36 36 35 35 35 35 33 32 33 31 32 31 31 33 35 33 38 37 38 39 40 38 39 39 40 44 42 43 43 44 45 46 46 48 
39 43 36 36 36 36 35 36 36 34 35 32 33 32 31 32 31 31 30 33 32 36 36 37 37 40 39 39 38 41 44 42 43 44 44 44 45 47 48 48 
38 37 38 39 37 37 40 39 39 40 41 38 42 42 42 40 46 39 42 44 35 36 37 38 39 39 41 42 43 43 44 44 47 48 48 48 53 50 52 53 
38 38 37 38 38 38 40 40 41 39 39 41 42 43 44 43 40 44 45 45 36 37 39 39 40 40 41 43 44 43 43 47 48 50 50 51 51 53 54 55 
37 38 41 40 38 40 37 41 41 42 39 42 44 46 38 44 43 45 43 43 37 39 40 40 40 42 43 45 46 46 46 46 51 54 48 53 52 60 54 54 
39 40 40 42 40 40 42 41 42 39 43 41 46 46 45 44 48 43 45 44 40 39 40 41 42 44 45 46 47 46 49 50 54 60 54 53 63 62 62 53 
39 40 41 41 41 42 40 42 42 43 40 45 47 48 44 48 44 44 44 48 39 40 41 42 44 45 46 47 48 49 49 52 60 57 54 57 61 60 54 55 
40 40 38 37 41 41 43 43 44 43 43 47 46 46 47 45 42 45 43 43 41 41 43 43 43 46 47 48 49 50 51 54 53 53 53 60 52 53 51 51 
39 39 39 38 38 42 43 45 46 45 45 46 47 45 45 42 45 43 43 43 40 43 43 44 45 46 48 50 52 52 52 54 53 53 53 52 53 51 51 52 
40 38 36 39 40 43 45 47 47 44 47 49 46 43 43 43 42 43 44 44 42 43 45 46 47 48 48 52 60 52 61 51 52 50 50 52 50 51 51 51 
37 39 39 41 44 45 46 46 47 48 45 47 44 43 42 41 41 44 43 45 42 44 45 46 49 50 52 54 55 60 52 54 51 51 50 49 50 50 50 52 
39 38 40 43 43 45 46 48 48 45 48 44 43 41 42 41 42 44 45 44 43 45 48 48 49 51 53 61 57 52 55 51 51 49 50 50 50 52 51 51 
39 39 40 41 40 41 39 42 41 41 44 45 44 45 45 45 47 45 44 44 43 45 45 45 46 47 47 50 49 49 52 52 52 53 53 52 61 52 53 53 
39 40 40 39 39 40 42 41 41 42 44 44 45 45 46 45 46 44 45 46 44 45 46 46 46 48 49 49 49 49 51 52 53 53 54 51 53 53 60 61 
39 40 43 41 42 40 41 41 41 42 44 45 46 47 45 47 44 45 45 45 45 46 46 46 49 48 49 49 48 48 52 53 54 54 52 55 51 54 60 54 
41 40 40 38 40 40 40 41 41 43 44 46 48 48 47 45 47 46 45 44 47 47 47 47 48 47 48 47 48 50 53 53 53 60 54 54 62 55 61 53 
38 40 39 39 40 39 41 43 41 42 46 47 47 48 45 48 44 44 44 44 47 46 47 47 47 48 48 50 49 49 52 53 61 56 53 62 60 60 61 54 
39 39 40 40 40 40 42 42 42 42 45 43 45 44 44 44 45 45 45 45 47 48 47 47 48 47 49 50 51 51 53 52 53 52 52 60 60 54 54 61 
39 39 40 40 41 40 42 42 43 43 45 44 44 43 43 45 44 45 45 46 46 47 48 48 49 49 49 51 51 51 53 53 52 52 53 53 54 55 60 60 
39 40 40 40 42 42 41 43 42 42 43 47 44 44 45 45 47 46 46 46 48 48 49 49 49 50 53 52 51 51 52 53 53 53 53 54 63 61 54 60 
40 40 41 41 41 41 43 42 43 43 45 42 45 44 45 45 46 45 46 47 48 49 49 50 50 52 52 52 52 51 52 52 53 53 60 54 54 53 60 61 
39 41 40 41 42 43 42 43 43 44 42 44 44 43 44 46 46 46 46 47 49 49 50 50 51 52 52 51 50 52 52 53 53 54 53 54 60 55 60 55 
40 41 41 41 42 43 43 44 43 44 43 44 44 45 45 46 46 47 47 48 49 50 51 51 52 52 52 52 51 52 52 53 53 54 60 60 60 55 55 56 
