49 48 49 50 47 47 52 51 52 53 60 50 54 53 53 50 54 49 52 60 60 55 53 52 52 54 51 56 53 52 50 52 49 50 51 51 54 60 53 53 
49 49 48 49 49 49 51 53 53 51 53 60 53 52 53 53 49 54 54 60 60 60 52 52 51 53 56 52 52 52 50 49 51 52 52 52 54 53 53 53 
48 48 52 52 48 52 55 54 60 61 51 53 52 53 48 51 61 55 55 54 55 52 52 50 56 53 53 51 51 49 51 50 53 60 52 55 60 52 50 49 
50 49 50 52 51 52 60 60 60 54 53 52 53 53 51 52 53 55 58 53 53 60 50 50 60 53 52 51 48 49 50 52 54 56 53 53 54 49 49 49 
49 51 47 51 57 56 62 62 63 48 49 61 55 62 62 62 53 63 55 63 61 55 50 49 49 49 50 48 46 53 54 47 60 51 51 61 56 51 52 53 
48 50 52 52 53 57 55 63 57 51 51 61 56 57 58 61 57 55 62 56 53 52 49 49 49 48 49 46 46 50 51 52 51 50 50 62 52 53 52 52 
53 49 55 56 51 55 54 59 59 51 57 62 63 55 54 54 56 56 58 53 53 47 48 46 46 50 47 46 43 61 48 53 51 53 60 53 55 53 53 53 
50 54 51 55 57 63 57 58 65 64 55 65 54 61 55 56 60 65 64 52 47 50 47 47 46 46 47 43 43 48 52 47 60 52 61 60 54 55 60 52 
53 49 55 57 61 63 59 65 61 62 54 55 62 56 62 53 57 64 59 48 51 47 47 46 46 48 44 44 43 49 45 52 53 53 52 54 54 52 53 60 
53 52 53 53 52 53 60 61 61 56 56 62 62 62 56 62 61 57 57 47 49 47 53 50 50 50 48 50 50 50 49 51 49 50 51 51 53 52 50 49 
53 60 52 60 53 60 55 56 61 61 62 62 56 61 55 57 57 63 63 47 48 52 50 49 49 50 49 50 50 50 50 49 51 52 52 50 53 49 50 51 
52 53 60 54 54 55 63 61 55 55 56 64 61 54 57 61 57 64 59 52 50 52 49 48 50 48 53 52 53 53 50 51 52 53 52 60 48 49 47 47 
53 60 60 54 55 55 61 63 55 54 62 55 61 54 61 62 62 65 59 50 49 47 48 47 49 50 50 53 53 54 52 53 53 60 53 47 51 48 47 46 
52 60 54 54 55 55 55 60 54 54 61 61 60 53 56 61 58 54 54 47 47 48 49 48 49 49 53 53 60 60 52 53 53 53 49 52 47 48 46 45 
60 54 52 53 61 54 62 61 62 56 55 61 56 57 57 57 59 61 56 48 48 64 52 53 53 51 48 51 48 47 51 49 48 46 46 47 47 44 44 44 
53 53 53 60 53 61 61 62 62 56 60 55 57 58 65 64 54 63 63 53 51 60 53 54 60 49 52 47 48 48 51 48 46 45 45 47 45 44 44 44 
54 52 60 60 53 55 64 63 57 63 61 64 59 60 61 55 64 58 65 49 64 52 52 48 47 50 45 46 47 47 48 49 45 43 43 46 43 43 42 42 
52 53 53 61 55 62 57 58 63 63 57 64 54 55 62 65 58 66 66 65 52 64 49 49 46 45 46 48 46 47 47 45 43 43 43 42 44 43 42 41 
60 52 54 55 55 57 57 62 57 57 63 54 61 63 63 58 59 65 66 60 54 49 48 46 47 46 45 47 46 45 45 44 44 42 42 45 42 42 41 41 
53 52 51 48 52 50 46 45 43 42 41 44 41 41 41 43 38 46 41 40 51 51 48 47 47 47 45 47 45 45 44 44 43 41 41 41 39 40 40 40 
52 50 51 47 49 47 46 42 42 43 42 41 41 40 39 41 45 40 40 40 50 50 47 47 46 47 47 45 45 44 44 43 41 40 40 41 40 40 40 40 
52 50 46 46 49 45 43 42 43 40 43 44 40 38 46 41 42 39 39 40 50 45 46 45 48 46 46 45 44 44 43 42 40 39 41 39 40 40 40 40 
49 46 45 43 43 44 42 44 43 44 40 42 39 38 40 41 37 40 38 40 47 48 46 45 45 44 44 44 44 43 41 41 40 39 39 38 39 39 40 42 
46 46 43 44 44 41 43 43 43 41 43 39 37 37 38 36 39 40 39 36 48 45 45 46 45 44 44 45 43 40 41 39 39 40 38 38 40 41 40 42 
44 43 48 44 43 43 41 41 39 40 39 37 38 37 37 38 42 39 40 41 45 46 44 43 43 44 45 43 42 40 39 41 38 38 39 39 40 42 42 42 
46 43 45 44 42 41 42 39 38 38 38 38 37 37 37 41 39 41 41 41 46 45 43 43 44 43 44 42 43 40 39 39 39 40 41 40 41 42 43 43 
43 47 40 40 45 41 40 38 37 39 37 37 37 37 37 42 42 41 39 39 45 43 43 43 43 45 42 43 42 39 40 37 40 40 40 41 42 43 43 43 
46 40 45 41 39 39 38 37 36 36 36 36 36 37 39 40 43 40 40 39 42 45 45 44 42 42 44 42 42 40 37 41 39 40 41 42 43 43 43 44 
43 47 39 39 39 38 37 37 35 35 35 37 38 37 39 43 40 39 39 40 45 43 43 43 42 44 42 43 43 39 41 39 41 40 42 43 42 44 44 44 
41 40 39 38 40 39 39 37 37 38 37 37 38 38 38 38 40 40 41 42 43 41 44 43 43 41 41 39 39 40 38 39 38 37 37 39 39 42 40 40 
40 38 39 39 39 37 37 38 38 38 36 39 38 39 39 40 40 42 42 42 44 43 43 41 42 41 39 40 40 40 38 39 37 39 38 38 42 40 41 42 
40 39 38 38 38 38 38 38 38 38 38 36 39 39 39 41 41 42 42 42 42 46 42 42 40 40 42 41 40 40 39 35 39 39 41 41 40 41 41 41 
38 38 37 37 38 39 38 38 38 39 37 38 38 39 41 41 43 43 43 42 43 41 44 42 40 40 40 39 40 41 36 40 40 40 40 39 40 40 40 42 
36 37 37 38 39 38 38 38 38 39 38 38 41 41 40 43 42 42 42 43 40 43 41 41 39 40 40 41 40 42 40 38 40 39 38 40 40 42 42 41 
37 37 38 40 38 38 38 38 38 38 38 41 41 41 41 42 41 42 40 40 41 45 41 41 41 40 39 40 38 38 38 39 39 39 39 39 41 40 40 40 
37 37 38 38 40 37 39 38 38 39 39 41 41 42 42 41 42 40 40 40 42 42 41 41 41 38 41 38 38 39 38 39 39 39 39 39 41 40 41 41 
37 38 42 39 38 38 37 38 38 38 42 41 42 40 40 41 43 41 39 39 44 40 40 38 38 39 38 38 38 38 39 40 39 39 40 41 38 40 40 40 
39 39 38 38 37 37 38 37 38 40 40 43 41 41 40 41 39 39 39 40 39 43 40 39 37 37 37 37 37 40 39 40 41 40 39 39 42 40 41 41 
39 38 38 37 37 38 37 40 40 40 44 41 41 40 40 39 40 40 38 40 44 39 38 37 38 37 37 39 37 38 40 40 39 41 40 42 40 41 40 42 
38 37 37 37 37 38 38 40 40 41 42 41 41 40 40 39 39 40 40 40 41 39 39 37 37 37 37 38 39 39 40 40 40 39 40 41 41 42 41 42 
