10 10 09 09 10 09 09 08 07 07 07 08 08 08 09 09 11 11 12 12 11 15 12 13 14 16 16 20 16 15 13 13 10 10 10 09 10 08 09 10 
09 09 09 08 09 09 09 07 07 07 07 07 09 09 10 10 11 12 12 13 12 12 14 15 15 16 20 15 15 14 11 11 10 09 10 08 08 10 10 10 
10 09 09 09 09 08 08 08 07 07 08 10 10 10 10 11 13 13 13 11 14 13 15 16 19 19 16 13 11 12 11 11 10 09 08 09 11 10 11 11 
09 10 09 08 08 09 08 07 07 08 10 09 10 11 11 13 13 14 14 12 13 16 16 17 17 17 17 11 08 11 10 10 09 09 09 09 10 11 12 12 
09 08 09 08 08 08 08 08 07 09 10 08 11 11 11 13 15 15 16 18 18 13 15 12 11 15 16 09 09 11 10 07 10 10 10 10 12 13 15 16 
09 08 08 07 08 08 08 07 07 08 09 10 11 11 12 15 15 17 18 15 15 16 11 10 10 14 11 09 07 09 10 08 10 10 10 12 12 16 17 17 
08 09 08 08 09 08 08 07 07 11 09 11 12 13 14 15 16 18 19 18 13 12 10 09 09 13 11 07 04 10 06 14 11 13 14 13 16 18 18 19 
09 07 09 08 08 08 08 09 08 09 12 10 13 13 16 16 18 18 19 12 11 08 09 08 10 08 09 05 05 07 10 08 13 13 15 16 17 18 19 20 
06 09 08 08 08 08 08 07 07 10 09 12 14 14 15 17 18 20 21 09 08 09 10 07 07 10 06 04 04 10 06 13 13 14 15 16 18 19 20 22 
07 07 08 05 07 08 05 09 09 09 12 14 15 14 14 16 14 20 21 09 12 09 17 13 12 11 11 10 11 12 09 13 09 11 12 14 14 18 14 13 
07 06 07 06 06 09 08 09 09 10 14 16 14 15 14 17 18 21 22 09 11 16 12 12 11 11 10 12 14 15 10 10 12 13 13 14 18 13 14 14 
07 08 03 04 09 06 12 11 13 14 15 13 15 15 18 16 21 23 26 16 12 14 12 13 11 10 10 15 17 18 12 10 13 12 17 17 14 13 12 12 
07 05 06 04 07 10 08 14 13 15 15 16 16 15 17 21 20 25 26 12 11 10 14 11 10 13 14 17 18 20 12 14 11 13 16 13 14 14 11 11 
05 07 03 04 08 07 12 13 15 15 16 14 15 15 20 19 24 27 27 11 09 11 13 12 14 13 16 18 19 22 14 12 14 15 13 14 11 12 11 08 
05 06 06 08 10 11 14 16 17 18 16 20 22 23 24 24 26 30 31 10 11 24 18 20 21 16 11 17 12 10 12 09 11 09 09 10 13 09 10 10 
05 07 08 09 11 13 15 18 19 20 19 21 24 26 27 27 29 32 33 17 17 19 21 21 21 12 17 10 11 12 11 10 09 09 09 11 10 10 10 10 
07 07 10 12 13 15 17 20 22 23 21 24 27 29 30 29 31 34 36 12 25 20 20 15 14 14 10 11 12 12 09 11 09 10 11 12 11 10 08 08 
08 11 12 16 16 18 20 23 23 23 25 27 30 30 31 33 34 37 37 27 20 28 18 17 11 10 10 13 11 12 09 08 12 10 10 10 12 09 09 07 
12 11 14 15 17 19 21 22 25 25 26 28 29 31 32 33 35 36 38 23 30 17 14 15 13 09 10 12 09 09 08 10 10 10 09 12 09 08 07 08 
12 12 12 11 14 13 09 11 09 09 08 12 07 07 07 10 04 13 08 07 20 18 17 14 13 12 08 10 08 08 07 07 04 03 03 04 03 04 02 02 
12 10 13 11 11 11 10 09 07 10 08 08 07 07 05 07 12 07 06 06 18 17 13 11 10 10 10 08 06 07 06 05 03 04 03 02 05 02 02 03 
13 12 10 09 13 08 11 08 07 07 11 06 06 03 14 07 08 06 07 07 17 16 11 07 12 07 10 07 07 06 06 03 04 03 05 04 00 02 02 02 
11 07 08 06 08 09 05 06 06 10 05 09 02 03 06 06 03 07 05 08 13 11 07 06 07 07 04 07 06 05 04 05 03 03 02 00 02 03 02 02 
07 09 06 07 07 04 07 08 07 07 10 03 03 01 04 02 05 07 04 03 12 08 08 06 07 04 07 07 06 05 05 03 03 02 01 02 01 02 00 01 
06 06 11 09 07 07 06 06 04 05 05 03 04 03 03 04 09 05 06 06 09 12 08 08 08 06 06 05 03 04 03 02 01 00 00 01 03 01 02 02 
08 08 09 09 08 06 07 03 03 04 04 04 03 03 03 04 06 06 07 08 09 09 08 07 07 06 06 03 03 03 01 01 00 00 01 02 02 02 02 03 
06 11 08 06 09 06 04 03 02 05 03 04 03 03 03 09 05 07 05 05 11 08 07 04 03 06 02 02 02 02 01 00 00 00 00 03 02 03 02 02 
11 06 10 05 04 03 04 03 02 02 04 02 02 03 05 05 10 05 06 06 06 09 04 04 03 03 04 03 02 00 01 00 00 00 01 02 03 02 02 02 
07 11 05 04 04 04 02 03 02 03 01 03 04 05 05 11 05 06 06 07 10 05 04 03 04 04 02 02 00 00 00 00 01 00 01 03 02 02 01 03 
06 06 05 02 09 07 04 03 03 03 04 04 05 04 04 04 02 05 05 05 05 04 05 05 06 04 06 02 03 03 00 00 02 02 02 02 03 02 02 02 
05 03 07 04 06 06 03 03 03 03 04 05 04 03 03 04 04 05 04 04 05 04 06 05 06 04 03 03 03 03 01 01 02 02 02 03 03 02 03 03 
07 05 00 02 06 03 03 04 04 04 05 04 02 02 05 02 07 04 05 06 04 08 06 06 03 05 05 03 01 01 01 04 03 03 02 03 01 03 03 03 
03 00 02 00 02 02 02 03 04 06 02 03 04 02 03 05 02 06 05 06 05 04 06 06 05 02 04 02 02 01 01 02 03 03 03 03 04 04 03 03 
01 02 00 02 03 01 03 05 04 07 03 02 02 02 04 01 05 05 06 05 04 06 06 07 02 05 02 02 02 02 01 03 03 04 03 04 02 03 02 03 
00 00 06 05 02 03 02 05 03 03 02 06 05 05 06 04 04 05 03 03 04 04 02 02 02 02 01 01 00 00 01 02 02 01 01 03 02 03 03 03 
03 02 04 06 06 04 05 03 03 04 03 05 06 05 05 05 05 03 03 03 02 03 02 02 02 01 01 00 00 00 01 02 01 01 02 03 02 03 02 02 
01 07 05 03 07 04 04 04 03 03 07 06 05 03 02 04 04 02 02 03 03 02 01 00 00 01 01 00 00 00 03 00 01 01 01 02 05 02 01 01 
08 04 07 03 02 03 02 02 02 05 03 07 03 03 02 03 03 04 02 02 02 02 00 00 00 00 00 00 00 00 00 02 01 01 01 01 01 00 01 02 
05 08 02 02 03 02 02 04 02 03 08 03 03 02 03 03 02 02 02 01 02 00 01 00 00 00 00 00 00 00 02 00 01 01 01 01 02 02 01 02 
04 04 02 02 02 02 02 03 04 04 05 03 04 02 02 02 02 01 01 01 01 00 01 00 00 00 00 00 00 00 01 01 01 01 01 01 01 02 02 02 
