07 07 07 08 07 07 09 07 07 07 06 07 03 03 03 04 02 05 04 04 04 05 06 07 07 08 08 10 08 07 06 07 04 04 04 05 03 05 04 04 
07 07 07 08 08 06 08 07 07 07 06 05 03 03 02 02 04 04 04 04 05 05 07 07 07 07 09 07 07 07 05 05 04 03 03 04 05 04 05 05 
07 07 10 09 07 09 08 06 04 05 06 02 03 02 05 03 04 04 04 04 05 09 08 08 09 09 10 07 05 05 06 04 03 02 06 04 03 05 06 07 
08 08 08 10 07 09 08 04 04 03 04 04 02 01 04 04 03 04 04 06 05 07 08 08 09 08 08 05 03 04 03 04 02 02 04 04 05 07 07 07 
07 08 07 08 12 09 07 03 02 07 05 03 01 01 02 02 05 05 06 07 07 06 08 06 06 07 07 03 02 07 05 03 03 04 05 03 07 08 11 12 
07 08 09 07 07 08 05 02 01 05 03 02 02 02 03 03 05 07 08 06 07 07 06 05 05 06 05 02 02 05 05 02 05 05 05 07 07 12 12 12 
09 08 10 08 04 05 02 01 01 04 02 01 03 04 05 06 06 09 09 08 07 08 05 04 04 05 02 01 00 04 02 08 06 08 09 08 12 13 13 13 
08 06 05 04 04 03 02 02 01 01 02 02 03 04 07 08 10 08 10 07 05 05 05 04 03 02 03 01 01 03 05 04 09 09 09 11 13 13 14 14 
04 05 04 05 02 02 01 00 00 01 01 03 05 05 07 10 09 10 10 06 05 05 04 02 02 03 01 01 00 05 03 08 08 09 10 12 13 13 14 16 
05 05 04 06 06 05 06 02 03 04 03 04 05 04 04 06 06 09 09 04 05 04 08 06 05 05 06 06 08 09 05 08 08 10 11 12 16 16 16 16 
04 04 05 05 06 04 04 04 05 05 03 05 04 06 05 06 09 09 11 04 04 07 05 06 05 06 05 09 08 08 08 08 11 13 13 13 16 16 16 17 
05 04 09 07 04 05 01 05 06 06 05 02 05 06 08 08 06 11 12 07 05 06 06 06 05 06 11 10 11 11 08 09 13 15 14 17 16 16 14 14 
05 06 04 04 04 04 06 07 07 06 03 06 06 06 07 08 10 12 13 05 05 04 04 05 07 10 09 12 12 11 12 13 15 16 18 16 18 15 15 14 
05 03 06 06 04 06 05 06 07 07 06 05 07 06 08 09 11 14 14 03 04 05 07 06 09 08 11 10 12 13 12 14 16 16 16 18 15 15 14 14 
05 05 06 07 05 05 05 07 07 07 05 08 08 09 09 10 12 14 14 04 05 11 10 10 10 11 08 11 10 10 13 12 13 11 11 15 16 13 13 14 
05 05 05 07 08 05 06 07 07 08 05 08 09 11 12 11 14 14 15 07 08 10 10 11 12 10 11 10 09 09 11 14 11 12 13 13 14 14 14 14 
05 06 09 07 07 06 07 08 08 08 09 06 11 12 13 14 12 15 17 07 13 09 11 08 07 09 11 09 10 10 12 09 12 12 13 15 12 14 14 14 
07 06 06 07 06 07 07 08 08 09 08 13 13 13 13 14 17 18 18 13 09 13 07 08 08 09 08 10 09 11 10 11 12 12 14 14 15 14 14 14 
05 06 06 06 07 06 07 09 08 09 13 11 13 13 14 16 16 17 19 10 14 08 09 07 09 07 09 10 10 09 11 11 14 13 13 15 13 14 14 15 
06 06 06 05 06 06 04 05 05 05 07 06 09 06 05 06 03 06 05 05 09 09 09 07 07 08 04 08 06 05 04 07 04 07 08 09 12 13 12 12 
06 06 06 06 05 06 05 05 06 05 06 10 05 06 04 05 06 05 08 09 09 09 07 07 05 06 08 05 05 06 05 04 08 09 10 09 13 12 13 13 
06 06 05 04 06 04 05 08 11 09 08 04 05 04 07 04 04 08 10 11 09 07 06 04 09 05 06 05 06 03 06 06 10 11 11 14 11 12 10 09 
05 04 04 04 03 07 06 11 11 06 03 05 03 03 03 05 06 08 10 14 06 07 05 04 04 05 03 06 05 07 08 11 10 12 14 11 13 09 10 10 
03 04 03 03 07 05 09 11 11 03 05 03 05 04 05 05 08 12 12 14 07 04 05 03 05 03 05 07 07 08 10 10 12 14 11 14 10 11 10 10 
03 04 05 07 07 09 11 14 15 03 03 13 09 10 11 08 07 11 09 08 04 08 05 06 06 04 05 05 04 09 09 04 07 06 06 10 14 10 12 13 
04 06 06 08 10 10 13 16 17 08 09 09 11 12 12 07 11 08 09 10 05 06 06 06 06 05 05 04 03 06 07 07 06 07 08 12 11 13 14 15 
05 06 09 10 11 13 15 18 19 04 13 12 12 09 08 10 07 09 09 10 08 06 05 03 03 05 04 03 01 10 05 05 07 10 11 13 11 15 15 15 
07 10 10 12 13 15 17 19 20 15 11 16 10 10 07 08 09 10 09 10 06 08 05 04 02 03 03 01 01 03 07 05 10 10 13 12 16 14 16 16 
09 09 12 12 14 16 18 20 20 12 18 10 09 10 09 09 08 10 10 09 09 04 03 02 03 04 01 02 01 07 03 08 11 10 12 16 14 16 16 18 
10 09 10 07 09 09 05 08 05 05 11 11 09 08 08 08 09 09 09 09 07 06 08 06 06 06 04 06 06 06 08 10 12 13 13 14 16 17 17 17 
10 08 09 08 07 08 08 05 06 06 10 10 08 09 08 08 09 09 09 09 07 08 06 05 05 04 05 06 07 08 09 11 13 14 14 15 17 17 18 19 
09 10 04 04 10 06 04 06 07 07 10 08 09 09 08 09 09 09 09 09 07 07 05 04 06 04 06 08 10 11 11 13 15 17 16 18 14 18 18 18 
08 04 07 04 04 04 04 06 06 09 09 09 09 09 09 08 10 09 09 09 06 04 04 03 04 06 07 10 11 13 13 15 18 18 17 15 19 17 18 20 
04 08 03 03 04 03 05 08 07 07 09 08 10 10 07 10 09 09 08 09 04 04 04 03 05 06 09 11 13 14 14 16 17 19 15 19 17 20 20 20 
04 04 06 07 04 05 07 07 07 07 08 09 08 08 09 08 08 09 09 09 04 09 08 09 10 09 09 13 13 13 14 16 17 17 18 17 18 19 19 20 
05 05 05 05 07 07 07 07 08 08 09 08 09 08 08 10 08 09 09 09 05 08 10 11 11 11 12 13 14 15 15 16 18 18 18 17 19 20 21 21 
04 06 08 06 07 08 07 08 08 08 08 10 09 08 08 08 12 09 10 10 10 09 11 09 09 11 13 15 15 15 17 20 19 19 19 19 19 21 21 22 
07 07 07 06 06 07 09 08 08 08 08 08 08 08 08 10 09 12 10 09 09 12 08 10 10 11 13 13 14 17 18 19 19 19 19 20 21 22 22 22 
07 07 06 05 07 09 07 08 08 08 08 08 08 09 09 09 10 09 10 09 13 09 10 10 12 12 13 16 16 17 19 19 18 19 19 21 21 22 21 22 
06 06 06 06 07 08 08 08 08 08 08 08 09 08 09 09 10 09 09 10 11 10 12 11 12 13 14 16 17 18 19 19 19 19 20 21 22 22 22 23 
