10 09 09 09 09 09 04 06 04 03 03 03 02 01 01 02 00 04 03 03 03 02 03 02 02 01 01 01 02 02 04 03 07 06 06 06 08 07 08 09 
09 09 09 08 06 06 06 03 03 03 02 03 01 01 00 02 03 03 02 02 03 02 02 01 01 02 01 02 03 02 05 06 06 07 07 06 07 09 09 09 
09 09 10 07 09 04 02 03 04 03 03 00 01 00 03 01 05 02 02 03 02 05 02 00 01 00 04 05 06 06 05 05 07 08 06 08 09 09 09 09 
09 09 06 05 05 03 03 04 04 01 01 02 00 00 04 02 02 03 02 04 02 01 00 00 02 01 03 07 08 05 07 07 09 09 07 07 09 09 09 10 
09 06 08 05 00 01 03 03 02 04 03 03 00 00 00 00 02 02 01 02 01 03 01 03 04 02 04 09 09 04 05 11 10 10 11 10 07 09 06 06 
08 06 04 02 03 02 04 02 03 03 03 01 00 01 01 00 02 01 02 02 02 01 04 04 05 03 07 10 11 07 09 10 11 10 10 10 08 06 04 04 
04 06 02 01 04 04 00 03 03 02 02 00 01 00 00 03 00 02 02 01 02 04 05 06 07 07 10 12 13 07 12 11 10 07 06 07 09 05 05 05 
05 02 04 01 00 00 04 04 03 02 01 02 00 01 01 02 04 02 03 03 04 05 06 07 08 10 11 11 13 13 08 12 07 07 06 07 04 06 04 04 
03 05 00 00 01 04 02 03 04 01 02 00 01 01 02 04 02 03 03 05 05 06 07 08 10 10 12 14 15 08 13 08 07 06 06 04 05 04 05 03 
02 02 01 03 05 04 05 02 02 02 01 01 01 01 01 01 02 03 01 05 04 05 03 03 03 04 01 04 02 01 07 06 07 07 07 06 06 05 05 06 
01 02 03 04 05 03 03 02 03 04 00 01 01 02 01 02 03 01 02 05 05 03 03 02 02 01 04 01 02 02 08 06 07 05 06 05 04 06 04 04 
03 02 06 05 03 04 02 03 02 02 01 00 02 02 02 03 03 02 02 03 04 03 02 01 05 02 02 02 01 01 06 10 06 06 05 05 09 05 06 06 
02 04 02 04 04 01 04 02 03 03 00 02 02 02 03 02 03 03 02 04 03 03 02 01 01 00 00 00 00 03 08 05 08 06 06 07 05 08 06 05 
04 02 04 05 01 04 02 03 04 04 02 01 03 04 03 03 02 01 01 01 04 01 01 00 00 00 00 03 01 01 05 07 05 06 05 05 06 04 05 05 
03 02 05 03 02 02 01 02 01 01 01 02 02 02 02 01 02 01 00 02 01 01 01 01 01 00 03 03 04 05 06 06 06 06 06 06 05 06 06 06 
04 01 03 03 02 02 02 01 01 01 01 02 02 01 01 00 01 00 00 01 00 00 01 01 01 03 02 05 04 04 06 06 06 06 06 05 05 06 06 06 
02 05 01 01 04 01 00 00 00 00 02 03 01 00 00 01 00 00 00 01 00 03 02 02 02 03 06 04 03 03 06 06 06 05 05 05 09 06 07 07 
04 02 04 02 00 00 00 00 00 01 00 01 00 00 00 00 01 00 00 01 01 01 02 02 03 05 05 03 04 04 06 05 05 05 06 06 06 09 07 06 
03 05 01 00 01 00 00 01 00 00 01 00 00 00 00 01 00 00 00 01 00 02 02 04 03 05 04 04 04 05 05 05 06 05 06 05 07 06 08 06 
02 01 02 01 01 01 00 01 00 00 00 00 02 02 03 02 06 02 03 04 01 02 01 00 00 01 00 03 01 01 00 02 00 01 02 03 03 04 02 02 
02 01 01 01 00 00 01 00 00 00 01 01 03 03 04 04 03 04 05 05 00 02 00 00 00 02 02 01 01 01 00 01 02 02 02 03 05 02 03 04 
01 01 01 00 01 00 00 01 01 01 00 03 04 04 02 05 03 05 05 05 02 00 00 00 02 01 03 02 02 00 02 00 02 02 04 04 00 03 04 04 
01 01 01 00 00 00 00 01 01 01 02 02 03 04 05 04 07 06 06 04 00 02 02 01 01 02 00 02 01 02 00 03 02 03 03 02 04 04 04 05 
00 01 00 00 00 00 00 02 01 03 01 03 06 06 05 07 05 04 05 05 02 00 00 00 01 00 01 02 00 01 03 02 03 02 02 04 03 05 03 04 
00 00 00 00 00 00 02 02 02 02 02 04 05 04 04 05 03 03 02 02 00 02 01 01 01 01 01 02 01 01 01 00 01 00 00 03 05 05 05 06 
00 00 00 00 00 01 02 02 03 03 03 04 04 03 03 03 04 02 03 03 00 01 01 01 01 00 01 01 01 00 01 01 00 02 03 03 05 06 07 08 
00 00 00 00 01 02 01 03 03 03 04 06 03 02 02 03 00 02 02 03 02 01 01 00 00 01 03 01 00 02 01 00 02 03 04 06 06 07 07 07 
00 01 01 01 01 02 03 02 03 05 03 04 02 02 02 00 02 02 02 04 00 02 00 00 01 02 01 01 00 00 00 01 03 03 05 06 07 06 07 08 
00 01 00 01 01 03 02 04 03 04 04 03 02 00 01 02 01 03 04 03 02 00 01 00 01 01 00 00 00 00 01 02 04 04 05 07 06 08 08 09 
01 01 01 00 01 01 00 02 00 00 03 03 03 02 02 02 01 03 03 03 01 00 02 02 03 02 07 04 05 06 02 03 04 04 04 05 05 08 07 07 
01 01 01 00 00 02 01 00 00 00 03 03 02 01 01 03 02 03 02 02 01 02 03 04 05 05 04 06 06 07 02 04 04 05 04 05 07 07 08 08 
01 01 00 00 02 01 03 01 01 02 03 04 01 00 03 01 06 03 04 04 01 03 05 07 02 06 08 07 06 06 04 05 05 05 07 07 07 08 08 08 
01 00 01 00 01 02 00 03 01 01 02 01 01 00 02 04 02 05 04 04 05 03 07 07 08 08 09 08 08 05 04 05 06 06 07 06 07 07 08 10 
00 01 00 00 01 00 01 01 01 00 01 01 00 00 03 01 04 03 04 04 02 06 07 07 07 09 08 06 06 07 05 05 06 06 07 07 07 09 09 09 
00 00 01 01 01 01 01 00 00 00 01 02 02 02 02 03 04 05 06 07 05 07 07 07 07 07 05 06 04 04 04 06 06 07 07 07 08 09 09 09 
00 00 01 01 01 00 01 00 00 01 01 02 02 03 04 06 04 07 05 05 07 07 07 06 06 06 06 04 04 04 05 06 07 07 08 08 09 09 10 10 
00 01 02 01 01 01 00 00 00 01 03 00 03 03 03 04 09 06 06 07 07 08 06 06 06 05 05 04 05 06 07 08 08 07 07 09 09 10 10 11 
01 00 01 01 01 01 01 01 01 01 00 03 02 03 05 07 06 08 07 06 08 07 07 06 05 04 04 07 06 06 06 08 06 07 09 09 11 11 11 11 
01 01 01 01 01 01 00 01 01 01 03 02 04 03 05 05 07 06 06 06 07 06 05 05 04 04 05 05 07 05 08 07 08 08 09 11 10 11 10 11 
00 01 01 01 01 01 01 01 01 01 03 03 05 05 06 06 07 06 06 07 06 06 05 04 04 05 06 05 06 06 07 07 09 09 10 11 11 11 11 12 
