10 10 10 10 11 10 12 10 09 09 08 10 09 09 09 10 10 14 13 13 12 14 13 14 15 16 15 17 16 16 17 14 18 17 17 15 18 14 17 18 
10 10 10 10 11 11 11 09 10 09 09 09 09 09 09 10 13 13 12 13 13 13 15 15 15 15 17 16 17 15 16 18 17 17 17 16 14 18 18 19 
10 10 10 11 10 12 08 10 10 08 10 10 10 10 12 11 15 12 12 12 14 17 15 15 17 16 15 17 17 19 16 16 17 17 13 16 18 19 20 20 
10 11 11 13 09 09 12 10 10 09 08 10 10 10 13 13 12 13 11 14 14 15 15 15 16 17 17 17 18 17 16 16 18 18 15 17 18 20 23 24 
10 11 11 11 14 13 11 10 09 12 11 09 10 10 11 11 14 12 12 16 16 13 15 15 16 16 19 18 19 13 14 20 18 19 19 20 17 22 20 20 
10 10 12 11 10 12 10 09 07 10 09 10 11 11 11 12 13 13 14 14 16 14 16 16 16 16 19 20 22 16 16 19 19 21 22 20 21 20 20 20 
12 12 11 11 10 10 10 08 07 11 09 11 11 12 13 14 12 15 15 16 13 18 17 19 20 20 17 22 24 16 22 17 21 19 19 19 22 21 22 23 
12 10 10 09 09 09 07 07 07 09 10 10 13 13 14 14 16 16 16 14 16 15 20 19 20 20 24 25 25 22 18 24 20 21 19 20 19 24 22 23 
10 11 08 09 08 07 07 07 07 10 09 12 13 14 14 16 15 16 15 15 14 18 19 21 20 23 23 24 27 20 25 20 20 21 21 18 22 22 21 22 
09 09 09 06 09 09 06 08 08 08 11 12 14 15 15 15 20 18 18 16 17 17 20 19 19 19 18 18 17 17 19 20 19 20 21 21 22 22 21 21 
09 08 09 07 07 07 08 08 08 09 12 13 15 17 17 17 19 19 21 16 19 19 19 18 18 18 19 17 18 19 19 18 21 20 21 21 22 21 20 20 
09 09 04 05 09 06 09 09 12 13 13 14 18 20 16 21 16 21 21 18 18 21 19 17 19 18 16 18 19 19 19 24 22 20 22 22 23 20 18 18 
07 04 06 05 06 09 07 13 12 13 16 17 20 21 21 20 24 22 22 18 19 17 17 17 17 17 18 19 19 20 21 21 20 21 22 21 20 18 18 18 
05 07 04 04 09 06 11 12 13 13 16 19 21 23 20 24 20 21 22 17 17 18 18 18 16 18 18 19 20 19 21 21 21 22 20 21 19 19 18 17 
04 05 07 07 09 10 12 13 14 14 18 19 20 20 20 21 21 21 21 18 17 22 19 20 21 17 17 19 18 18 20 18 18 16 16 19 20 18 19 19 
05 05 08 10 10 10 13 14 16 17 19 20 20 21 21 20 22 21 22 20 19 19 21 20 20 17 18 18 17 17 18 19 16 16 17 20 18 19 19 19 
06 08 08 09 12 13 12 16 17 17 20 21 21 22 23 22 19 22 24 17 21 22 20 19 19 17 20 17 17 17 17 16 16 16 16 19 19 19 18 18 
08 10 11 11 12 13 16 16 17 19 21 22 24 23 22 22 23 25 25 22 21 23 21 20 17 19 17 19 17 16 16 15 16 16 17 17 19 17 18 19 
08 10 11 12 13 15 15 18 17 20 21 22 22 21 22 23 23 24 25 21 23 20 18 19 19 17 17 16 15 15 15 16 17 15 16 19 18 19 19 20 
10 10 11 12 12 13 11 14 14 15 17 16 20 19 19 19 20 20 20 20 20 20 20 19 19 18 17 18 19 20 21 20 23 20 20 20 19 19 19 19 
10 12 11 13 11 12 13 15 16 15 16 19 19 19 19 19 20 20 21 22 20 20 19 17 18 19 17 20 19 20 21 23 20 20 19 19 19 19 20 20 
11 12 14 12 14 12 16 17 18 19 18 19 19 20 20 20 19 22 23 23 19 22 18 16 18 16 23 21 22 23 21 21 20 20 20 19 17 20 21 22 
12 12 11 10 13 17 15 18 19 18 19 19 20 20 20 20 22 23 23 24 18 17 15 15 17 20 18 22 22 21 21 19 20 19 18 19 19 21 21 23 
10 11 11 11 15 14 18 19 20 19 18 19 21 20 21 21 22 23 23 24 17 16 16 14 19 17 22 22 24 19 19 19 20 20 19 19 20 22 22 23 
11 12 13 14 17 18 20 22 23 19 19 25 23 24 25 22 20 22 20 20 17 18 19 20 21 21 22 24 24 20 19 26 22 23 24 20 18 20 18 17 
12 13 15 16 17 19 21 24 25 22 21 23 25 24 24 22 22 20 19 19 18 19 21 21 22 20 24 25 27 23 23 22 24 22 22 18 21 17 18 18 
14 14 15 17 19 22 22 26 26 20 26 25 23 20 19 21 21 19 18 18 19 21 22 23 24 24 22 27 28 19 26 26 22 18 17 19 16 17 17 17 
14 18 18 20 22 23 25 25 27 27 23 26 20 20 18 19 18 17 17 19 21 22 24 24 24 24 27 28 29 27 22 26 19 19 16 17 17 17 16 18 
17 17 19 21 22 25 25 28 30 25 27 21 20 20 19 18 18 19 18 18 21 23 23 24 25 26 27 30 30 23 27 20 18 16 18 17 16 18 16 16 
18 18 19 20 20 20 21 21 21 21 22 21 21 19 19 18 18 17 17 17 21 22 20 20 20 20 18 19 17 16 21 20 21 21 22 20 23 19 20 21 
18 19 19 19 20 19 22 21 20 20 22 20 19 18 18 16 18 17 16 16 21 20 20 18 19 19 20 16 16 16 22 20 22 20 22 21 19 21 19 19 
19 19 22 21 21 21 20 20 20 20 20 23 19 18 18 17 16 16 14 14 21 23 19 17 21 18 16 16 16 16 20 25 22 23 19 21 23 20 17 17 
20 21 20 20 21 20 21 21 20 19 20 19 19 18 17 16 15 13 14 15 20 19 18 17 17 16 15 16 15 16 23 21 25 23 22 19 21 17 18 17 
19 20 20 21 20 21 20 19 18 18 19 19 17 17 16 15 14 15 15 15 20 18 17 15 14 15 15 16 14 15 20 23 22 24 19 21 19 18 18 18 
20 20 21 18 20 19 19 17 15 15 18 18 16 16 16 15 15 14 13 13 18 16 14 14 14 15 17 16 16 16 21 20 18 17 17 18 18 18 18 18 
20 19 20 18 17 17 18 15 16 16 17 16 16 15 15 13 15 13 14 15 16 15 14 14 15 17 16 16 16 17 20 19 17 17 17 19 18 18 17 17 
20 21 16 16 18 18 13 15 13 13 17 16 15 15 15 15 11 13 14 14 15 13 14 14 15 17 17 17 17 17 19 17 17 17 17 17 19 17 17 17 
20 16 18 16 15 14 15 12 13 15 14 16 16 15 14 14 15 15 14 14 14 14 14 15 16 18 18 18 17 16 18 18 18 17 16 17 16 16 16 18 
16 19 15 15 15 16 13 15 13 14 16 15 14 14 14 15 13 14 14 14 14 14 16 15 16 18 17 16 16 17 18 17 16 17 16 16 16 17 18 17 
16 16 15 14 14 14 13 15 14 14 15 15 14 14 14 14 14 14 14 14 14 15 16 16 17 17 17 17 16 17 17 17 16 16 16 16 16 17 18 18 
