51 50 50 49 50 50 47 48 46 46 45 46 45 45 46 46 45 46 45 45 45 44 44 43 43 42 41 41 41 41 39 43 38 39 40 42 38 44 40 39 
50 51 50 49 48 48 48 46 46 46 46 45 46 45 45 46 46 45 45 44 44 45 43 42 42 41 41 41 39 42 41 39 40 39 39 40 43 39 39 40 
50 50 49 48 50 47 45 45 45 45 46 46 45 45 47 46 44 44 44 45 44 43 41 41 42 40 42 40 39 38 41 40 39 37 44 40 40 39 39 40 
49 48 48 46 47 48 46 46 45 45 44 46 45 45 45 44 45 44 44 44 43 42 41 39 42 39 39 39 39 39 39 40 37 37 42 41 40 40 37 37 
50 48 49 46 45 45 46 44 43 47 46 45 44 44 44 44 45 43 43 43 42 45 41 42 42 39 38 38 37 45 43 38 37 36 36 37 41 39 41 42 
49 46 47 45 44 44 46 43 44 46 45 45 44 43 43 45 44 43 44 44 44 42 42 40 39 38 38 37 35 41 40 37 36 36 36 39 39 42 41 41 
47 48 43 43 46 46 41 44 44 46 45 43 43 42 42 45 42 44 43 41 44 44 40 37 36 38 38 35 33 41 36 36 36 36 37 41 43 42 40 39 
47 43 46 43 43 42 45 45 44 44 43 43 42 42 43 43 44 43 43 44 42 42 37 37 35 35 35 33 33 35 36 34 35 36 39 40 42 39 40 40 
44 46 43 43 43 45 43 44 44 43 43 42 43 43 43 44 42 44 43 41 43 38 36 36 35 35 34 34 32 36 33 36 38 38 39 43 40 40 40 42 
43 43 42 43 46 45 48 43 44 45 42 42 41 40 40 41 39 42 40 40 39 38 37 35 35 35 35 36 36 36 36 36 39 38 38 39 37 40 40 40 
42 42 44 44 47 44 45 45 45 45 41 42 40 40 39 40 41 40 40 39 36 38 35 36 35 35 35 36 36 37 37 38 38 38 37 39 39 40 40 41 
44 43 45 46 44 47 43 45 44 44 42 40 40 38 42 40 41 40 40 39 38 34 35 35 35 35 39 38 38 38 38 38 37 37 40 38 41 41 43 44 
43 44 45 47 47 44 48 46 45 43 38 40 38 38 39 40 39 40 40 36 36 35 34 34 36 37 36 38 38 39 36 37 36 36 38 40 40 43 43 45 
45 44 47 49 44 48 44 44 44 44 41 38 39 38 39 38 40 41 40 36 35 34 36 35 36 36 38 38 39 40 37 36 38 36 39 39 42 43 45 44 
45 45 47 47 45 44 42 42 40 39 38 40 38 38 39 39 40 41 40 35 35 37 38 38 39 38 38 39 39 39 37 41 40 41 42 41 41 44 44 44 
46 45 46 46 45 41 43 39 39 40 39 39 39 40 40 39 40 40 40 36 36 37 39 38 38 37 39 39 40 41 39 40 42 43 43 42 43 44 44 44 
45 47 47 44 44 42 39 39 40 40 40 37 39 39 39 40 42 40 39 36 37 41 39 39 39 39 39 40 41 41 42 42 43 42 42 43 46 44 44 45 
48 44 45 42 40 39 40 41 40 40 38 41 39 39 39 39 40 40 39 38 39 39 40 39 38 39 40 41 41 42 42 45 42 43 42 44 43 45 44 45 
44 46 41 40 40 40 39 40 39 39 41 38 39 39 39 40 39 39 40 39 39 39 38 39 39 39 40 42 41 42 45 42 42 41 43 43 44 44 43 44 
43 42 43 46 42 42 47 44 44 44 44 42 44 42 42 41 41 40 41 42 39 40 40 40 40 40 41 42 42 42 43 42 45 45 46 45 48 46 47 47 
43 44 42 44 44 43 45 44 46 43 43 43 42 41 41 41 40 42 41 41 39 40 40 41 40 39 42 42 43 42 44 44 46 46 47 45 46 47 48 48 
42 42 49 48 43 47 41 45 44 44 42 45 41 41 40 40 44 42 43 44 40 40 41 41 41 42 41 44 45 44 43 47 47 48 45 48 48 48 48 48 
44 46 45 47 47 45 48 44 45 42 41 40 41 40 41 43 42 45 44 43 40 41 41 41 42 43 44 46 46 44 45 45 48 48 48 49 49 48 48 48 
46 44 48 48 44 49 44 45 45 39 40 41 41 41 43 41 44 42 44 44 41 40 41 42 42 44 44 45 46 46 44 47 49 49 47 49 48 48 49 49 
46 45 43 42 45 44 45 43 43 40 40 43 42 41 41 43 42 43 42 42 41 41 44 44 45 44 45 47 48 45 45 48 48 47 47 48 46 47 46 46 
44 43 44 42 41 44 44 43 44 41 41 43 41 42 43 41 43 42 42 42 41 42 45 44 44 45 46 48 48 46 48 48 47 47 48 47 47 46 46 46 
45 43 41 42 42 44 41 44 45 41 44 41 42 41 41 42 42 42 42 42 42 47 45 45 45 46 49 49 50 46 49 49 47 46 46 46 47 46 46 46 
42 42 42 43 44 44 45 46 46 44 41 44 41 41 41 42 41 41 42 44 45 43 44 45 47 48 48 51 50 49 47 49 47 46 45 46 45 47 46 46 
42 41 42 44 43 45 44 45 46 43 44 41 42 42 41 41 42 43 43 43 43 45 46 46 47 48 49 49 50 47 49 46 46 45 45 45 46 46 46 45 
42 42 41 42 43 42 44 43 43 43 41 41 41 40 40 41 37 42 40 39 44 44 44 43 43 44 43 46 45 45 46 46 45 44 44 44 43 45 44 44 
41 43 42 42 43 42 42 43 42 42 41 41 40 38 38 40 40 39 39 39 44 44 43 43 43 44 45 45 44 44 47 46 44 44 43 45 44 44 43 43 
42 41 44 44 42 43 46 43 41 41 41 41 38 36 42 38 43 40 41 42 44 45 44 44 45 44 48 45 45 45 46 45 44 43 45 43 45 44 45 45 
42 42 42 44 44 44 43 41 41 41 39 39 38 37 38 41 37 42 41 42 43 45 46 45 45 45 44 46 45 45 45 44 43 43 43 44 43 46 45 45 
43 42 44 44 43 43 42 41 41 42 40 38 36 36 40 36 41 41 41 41 45 45 44 44 45 44 45 45 45 44 44 43 43 43 42 43 45 44 45 44 
42 42 43 42 43 42 41 41 40 40 38 39 39 39 40 40 41 40 40 40 44 45 43 42 42 44 44 44 43 43 44 44 44 44 44 44 44 44 44 45 
42 43 43 42 42 42 41 40 40 40 39 39 40 40 40 39 41 40 41 42 44 44 42 43 44 44 44 43 43 44 43 44 44 44 44 43 44 45 45 45 
42 43 42 41 42 41 41 40 40 40 40 40 40 40 40 42 38 41 41 41 45 40 43 43 43 44 44 44 43 43 44 45 44 44 45 44 45 45 44 44 
43 41 42 40 40 39 40 40 40 40 40 41 41 41 40 41 42 41 42 42 43 45 44 44 43 44 44 43 43 44 44 45 46 45 44 44 44 43 44 45 
41 42 39 40 39 40 40 40 39 40 41 40 40 40 41 42 41 42 43 43 45 43 43 43 43 44 43 44 43 44 45 45 44 43 44 44 44 45 44 45 
40 40 39 39 39 40 40 40 40 40 41 41 41 40 41 42 42 43 42 43 44 44 44 43 43 43 43 44 44 44 45 45 44 44 44 44 44 45 45 45 
