02 02 02 03 02 02 08 05 07 08 09 06 10 08 07 06 06 05 07 08 07 10 07 07 07 09 04 11 08 07 06 06 05 04 04 04 04 05 08 09 
02 01 02 03 05 06 05 08 09 07 07 10 07 07 06 07 04 08 08 09 09 08 07 06 05 09 10 07 06 06 06 06 04 04 04 04 04 09 09 09 
02 02 04 06 02 08 08 09 09 11 08 08 07 07 05 05 08 10 11 07 09 07 05 03 11 06 10 06 06 06 05 03 04 04 04 04 09 10 12 13 
03 04 05 09 05 06 10 09 10 09 07 07 07 05 06 07 08 12 14 07 06 08 03 02 10 08 05 07 05 04 05 05 04 04 06 07 07 13 15 16 
02 05 02 04 14 13 12 12 13 05 05 13 08 09 10 08 07 12 09 12 09 09 03 03 03 02 05 05 05 05 04 05 05 07 08 07 11 16 18 19 
02 04 08 08 07 13 11 14 14 09 07 09 10 11 12 07 12 09 10 10 08 05 03 03 04 04 05 06 06 05 06 04 08 09 10 10 14 19 22 23 
08 05 07 10 08 11 14 15 17 05 13 08 11 09 08 09 07 10 11 06 06 02 03 04 04 06 06 06 04 04 04 07 11 13 14 14 17 23 25 26 
04 07 07 10 14 15 14 18 18 13 10 15 09 10 08 09 09 10 10 05 04 05 05 05 04 05 07 03 04 05 08 09 11 14 17 20 22 25 26 28 
08 05 10 14 13 13 17 17 18 12 16 09 09 09 10 08 09 13 12 03 05 04 04 04 05 07 04 05 05 09 08 12 15 16 19 21 23 26 27 30 
08 07 08 08 05 06 06 10 10 10 11 11 12 12 12 12 12 11 11 04 06 05 09 06 06 06 06 09 11 12 10 14 16 18 19 22 22 27 26 26 
08 08 06 08 05 08 08 10 08 08 11 11 12 12 12 11 12 11 13 04 05 09 06 07 06 07 07 12 13 13 12 14 19 19 20 21 27 26 28 29 
06 07 09 07 08 08 12 09 08 08 11 13 12 12 12 12 09 13 14 09 07 03 06 06 07 06 12 14 17 18 16 20 21 20 25 25 24 27 28 29 
08 08 08 08 09 09 08 09 08 08 11 12 12 12 11 13 13 14 15 06 03 05 05 05 07 12 11 15 17 21 18 20 19 21 24 25 26 27 28 31 
08 08 07 06 07 08 09 08 08 08 12 12 12 12 11 13 13 15 15 05 05 04 08 07 11 10 15 18 20 22 20 20 21 23 26 26 27 30 29 30 
07 07 05 05 08 08 10 09 10 11 11 12 12 13 13 14 15 18 19 04 06 14 14 17 18 16 15 21 20 20 20 20 23 23 23 27 31 32 33 34 
06 06 06 06 05 09 09 11 11 11 11 12 13 14 15 16 16 20 20 09 11 13 18 19 19 18 20 20 21 22 21 23 23 26 27 29 31 34 35 36 
07 05 05 07 06 10 12 11 11 11 12 13 15 15 16 16 22 21 21 08 16 18 19 18 18 18 22 22 23 24 22 21 26 29 31 32 35 36 36 37 
04 05 05 08 09 10 11 11 11 11 12 14 14 16 18 20 20 22 22 18 18 21 17 19 19 21 20 23 23 25 24 26 30 30 32 34 37 37 38 37 
05 04 07 09 09 11 11 11 11 12 14 15 17 18 19 19 22 21 21 17 22 18 19 19 21 19 22 24 23 24 25 27 30 32 33 36 37 37 38 39 
05 05 04 07 08 07 07 06 08 09 10 11 14 14 15 16 16 17 17 18 20 21 22 23 24 25 29 29 32 33 36 34 42 43 43 42 47 44 48 49 
04 07 06 07 07 07 05 09 09 10 11 13 15 15 15 16 17 18 19 20 21 22 24 26 26 27 29 33 35 33 37 40 43 44 45 45 43 49 50 51 
06 05 10 08 06 06 10 11 12 12 13 14 15 16 17 17 16 19 21 22 22 22 27 29 26 30 32 36 38 39 37 45 45 47 41 46 49 52 53 53 
06 06 05 05 07 09 10 13 13 13 14 15 17 17 17 18 20 22 22 22 24 27 29 30 31 35 37 39 40 39 43 41 47 47 48 50 53 60 61 53 
05 04 07 07 09 09 12 12 15 14 15 16 17 17 18 19 20 21 22 23 26 28 30 30 34 36 38 38 40 42 40 46 48 49 51 53 53 52 56 63 
05 06 08 09 10 11 11 15 15 15 16 19 18 19 19 20 20 21 20 20 28 27 32 33 34 38 40 44 46 43 45 51 51 52 53 53 50 54 53 53 
06 07 09 10 12 12 14 15 16 17 17 19 19 20 21 19 22 20 22 23 28 31 34 37 38 41 42 47 48 47 48 51 53 60 55 52 54 53 53 54 
07 09 11 12 14 13 15 17 19 17 20 18 20 20 21 21 18 22 22 22 30 31 37 41 42 42 49 50 52 47 53 51 53 52 52 52 53 54 56 63 
10 13 13 14 15 16 16 20 20 20 18 22 22 21 20 20 22 21 22 24 33 35 40 42 45 48 48 51 53 60 51 56 53 53 52 53 52 56 61 58 
11 13 14 14 16 15 18 20 22 20 22 20 20 20 21 22 21 24 22 24 33 39 43 44 46 47 52 53 56 52 62 52 53 54 53 51 54 56 56 56 
13 11 14 15 08 10 17 18 18 18 20 20 23 24 24 24 29 26 29 30 35 39 38 41 43 45 48 50 50 50 52 53 53 52 52 53 52 63 58 58 
13 14 11 14 12 12 18 18 20 21 21 22 24 26 26 26 27 30 33 34 38 38 43 44 45 47 50 50 50 51 53 54 52 53 52 55 61 58 65 59 
10 13 16 16 13 19 17 20 20 20 22 25 27 29 24 29 28 33 34 35 39 41 45 46 47 50 51 51 49 49 54 50 53 53 55 60 60 54 56 63 
14 17 19 21 20 18 23 21 20 19 25 26 29 30 30 32 35 35 36 35 42 45 44 47 51 51 51 49 49 50 51 60 53 53 61 58 58 57 63 58 
17 18 20 20 18 23 19 19 19 19 25 28 30 32 31 35 34 35 36 38 44 45 47 48 50 51 49 50 49 50 60 52 53 54 58 62 56 56 59 59 
18 18 11 14 19 19 22 20 23 24 27 29 31 32 32 34 34 38 38 39 45 42 46 46 46 50 53 51 53 54 53 61 63 58 65 61 63 66 68 69 
14 16 15 14 16 21 20 24 26 27 28 31 32 33 34 36 36 39 39 39 43 46 46 47 47 52 51 54 61 62 61 57 65 61 56 56 59 69 70 70 
18 11 17 19 15 22 22 27 28 28 30 31 34 36 37 35 41 40 42 43 43 45 47 50 51 53 53 56 62 62 62 58 62 63 64 59 68 71 71 72 
10 17 13 19 24 24 27 27 29 30 33 34 37 37 37 39 38 42 42 44 45 45 49 50 53 54 62 55 63 57 59 55 63 64 66 68 69 70 72 74 
15 10 20 23 23 27 27 29 31 33 33 35 36 38 38 37 41 42 42 44 43 48 51 52 53 56 56 57 62 65 54 62 59 66 67 68 71 73 73 75 
17 17 22 25 26 28 29 32 32 34 35 37 37 38 39 40 42 43 45 46 47 50 51 54 55 56 57 65 58 54 62 58 66 67 69 70 72 74 75 77 
