12 11 12 12 11 11 14 13 14 15 17 13 19 17 17 15 19 14 18 20 20 23 20 20 21 24 20 26 21 19 17 19 15 17 18 19 17 19 17 17 
12 10 11 12 12 13 14 15 16 14 16 18 17 18 18 16 14 20 21 21 20 21 21 21 20 21 26 19 19 19 19 15 18 16 17 18 19 17 17 17 
11 12 12 13 12 15 13 17 17 19 15 17 18 19 13 17 20 23 24 20 23 20 21 20 27 23 18 18 18 15 17 20 17 16 20 18 18 17 17 17 
11 12 13 14 12 14 17 18 19 18 18 17 20 20 16 19 21 25 28 20 21 23 20 20 22 22 21 18 14 17 16 17 16 16 19 19 18 17 16 16 
13 14 12 13 18 18 20 21 23 12 14 21 21 22 23 24 21 26 25 26 24 23 21 19 19 18 19 14 13 20 19 13 15 13 13 16 20 17 19 20 
12 13 15 15 16 19 20 24 24 16 18 21 23 25 26 23 26 25 26 24 22 21 19 17 17 17 16 13 12 16 16 15 13 14 14 16 18 20 21 22 
15 13 15 18 17 20 25 25 27 17 24 22 25 23 23 23 24 26 28 23 22 22 17 15 15 17 14 11 09 18 12 13 15 17 18 20 17 22 23 24 
13 17 16 19 22 23 25 29 28 25 23 27 23 24 24 24 24 28 28 21 20 18 16 15 14 12 14 11 10 10 14 11 17 17 20 20 24 24 25 24 
15 14 19 22 22 24 27 27 28 24 28 23 24 24 25 23 27 30 30 19 18 16 15 15 13 15 11 09 08 12 10 16 18 20 20 24 23 23 26 26 
17 17 18 18 17 18 19 21 21 21 24 26 26 26 27 28 27 31 31 18 21 17 26 23 23 20 23 17 20 21 14 17 14 13 13 16 10 19 14 12 
17 16 17 17 18 17 21 21 22 23 25 26 27 26 27 29 29 32 32 17 21 24 23 23 23 21 18 21 22 23 13 15 13 13 11 15 18 12 13 13 
17 18 19 19 20 21 19 22 22 23 26 27 26 26 29 28 34 33 34 25 20 24 23 23 18 21 20 23 24 24 17 13 13 11 20 14 13 12 14 15 
19 19 20 20 20 20 22 22 22 24 27 27 27 27 29 32 31 36 35 20 21 19 22 22 21 21 24 24 25 25 14 16 13 12 12 12 10 15 12 15 
19 20 19 20 20 22 21 23 23 23 27 27 26 25 31 30 34 34 35 20 18 22 25 23 21 24 23 24 27 28 17 12 11 11 12 09 12 14 12 10 
19 19 18 18 21 21 24 24 25 26 28 27 30 30 31 33 35 35 36 20 20 33 25 26 27 23 17 23 18 17 13 14 12 13 13 11 14 11 11 11 
18 19 19 20 20 22 24 26 27 27 27 29 31 32 32 33 36 37 40 26 25 27 27 27 28 20 23 17 16 16 12 12 13 11 11 11 12 11 11 11 
20 18 19 21 21 24 24 27 27 28 28 31 33 34 35 36 34 40 41 21 34 26 26 21 19 19 19 15 16 16 13 15 12 11 11 14 10 10 09 09 
18 20 20 23 24 25 27 27 28 29 30 31 34 35 37 37 41 41 43 35 27 34 23 22 16 16 13 17 14 16 13 13 13 12 10 10 13 10 10 08 
20 19 22 24 24 27 27 28 28 30 30 34 35 36 37 40 40 43 44 28 37 23 20 17 18 13 15 16 13 12 13 12 10 11 10 14 10 09 09 09 
21 21 19 19 22 20 21 18 19 20 19 21 17 18 18 20 19 23 20 19 25 25 23 22 22 21 21 21 20 20 20 17 20 19 19 16 18 11 13 14 
20 21 20 19 21 19 18 20 18 20 19 18 18 19 18 19 23 19 18 18 25 23 22 22 21 20 21 20 20 18 21 19 19 17 18 16 13 14 14 14 
21 19 19 20 18 19 21 18 17 18 20 15 18 18 22 21 22 17 16 16 24 23 22 22 21 21 21 21 21 21 17 22 17 18 13 15 13 15 14 14 
19 18 19 20 20 19 19 18 18 19 18 21 18 19 21 18 17 18 15 14 22 23 23 22 21 21 21 23 22 17 19 15 19 17 15 13 16 14 15 15 
18 18 19 21 17 19 18 17 17 19 21 18 19 18 18 18 16 15 12 11 23 22 21 21 22 21 21 21 20 18 15 18 17 17 14 16 14 15 17 17 
18 18 21 18 18 18 16 17 16 19 18 16 17 15 15 15 17 12 12 12 21 19 21 21 21 21 22 22 23 17 16 21 15 15 15 15 11 14 11 11 
19 18 19 18 17 18 17 16 14 17 18 16 15 13 13 15 13 12 11 11 21 20 21 19 19 22 21 24 23 19 16 17 15 15 16 12 14 11 11 12 
18 21 16 16 19 16 19 15 14 18 15 19 14 12 12 15 13 11 09 09 19 24 20 20 21 22 26 24 23 15 20 13 14 12 11 12 09 10 11 11 
20 16 19 15 15 16 14 15 14 15 14 12 12 11 12 12 13 10 10 08 22 18 21 20 21 22 23 22 23 19 15 19 13 13 10 10 09 11 10 12 
16 20 15 15 16 14 15 14 14 13 12 13 12 12 11 14 10 09 08 09 18 21 20 20 21 23 23 23 23 16 20 13 12 12 11 09 09 12 11 10 
16 15 15 13 12 12 13 12 12 12 12 11 12 09 09 08 07 08 09 09 19 18 16 13 13 13 09 11 08 07 14 14 11 09 09 09 05 08 06 06 
15 14 13 14 12 12 12 12 12 12 11 12 09 09 08 09 07 09 08 08 18 17 13 12 11 11 12 07 08 09 12 12 09 08 07 07 08 06 06 06 
14 14 11 12 12 13 14 12 10 09 11 09 08 08 08 07 12 10 11 11 17 13 11 09 14 09 08 08 09 09 13 10 07 05 10 06 07 06 06 07 
13 12 13 13 14 12 12 10 10 09 09 08 08 07 08 10 08 12 11 11 12 12 09 08 08 08 06 08 08 11 08 08 05 04 05 06 04 06 06 08 
11 13 12 13 11 13 11 10 09 09 08 07 08 07 08 07 11 10 10 11 13 09 09 08 06 06 08 10 09 09 09 05 05 03 04 03 06 07 08 07 
12 11 10 11 11 10 11 10 10 11 08 12 10 10 10 09 08 11 10 10 10 13 09 09 09 07 08 09 07 07 06 07 05 05 06 05 07 07 07 07 
11 10 10 10 10 12 10 11 09 09 10 10 10 10 11 10 10 10 09 09 09 10 09 09 09 08 09 07 07 07 05 06 06 06 06 07 07 07 07 08 
11 10 12 11 09 10 14 10 09 09 12 10 10 08 08 09 12 09 08 08 12 09 08 07 07 09 08 07 05 05 07 06 06 05 05 07 06 07 07 08 
10 10 09 10 09 10 10 09 09 09 10 13 09 09 08 09 07 07 07 09 08 11 09 08 06 07 07 05 05 06 06 06 04 05 06 07 08 08 08 08 
08 09 09 09 09 10 10 09 08 10 14 09 09 09 09 07 08 09 08 08 12 08 07 06 07 08 05 06 06 05 06 05 06 06 07 08 07 08 09 08 
09 09 09 09 09 09 09 10 09 10 11 09 10 08 08 07 07 08 08 08 09 08 08 06 06 06 05 06 05 05 05 05 07 06 07 08 08 08 08 08 
