04 04 03 04 04 03 05 03 02 02 01 02 01 00 00 01 00 03 02 02 02 03 02 03 03 04 03 06 04 03 02 02 03 04 05 04 09 05 08 09 
03 04 03 04 04 02 04 02 03 02 00 01 00 00 00 01 02 02 02 02 02 02 03 03 03 03 06 03 03 02 03 02 05 05 07 07 05 09 09 10 
04 03 05 05 03 05 01 02 02 01 02 00 00 00 02 01 04 03 03 02 03 04 03 03 06 05 05 03 03 02 02 08 07 08 03 08 08 10 09 09 
04 04 04 05 02 02 04 02 02 00 01 01 00 00 03 03 02 04 03 03 03 04 03 03 05 04 04 03 01 05 05 04 09 10 05 07 10 09 12 13 
03 04 03 02 07 05 04 02 01 03 02 01 00 00 01 01 03 04 05 05 04 03 02 01 01 03 04 01 01 02 04 01 08 07 07 13 13 13 14 15 
03 02 05 03 01 03 03 01 00 02 00 00 01 01 02 03 03 06 06 04 03 03 01 01 01 02 02 01 02 01 02 07 07 09 10 13 13 15 17 18 
05 04 01 02 02 02 00 00 00 01 00 00 02 03 04 04 08 07 06 04 03 00 01 01 01 03 01 02 01 07 04 05 09 12 14 13 13 18 20 21 
03 01 02 00 01 01 00 00 00 00 01 02 04 04 04 05 07 06 07 02 00 01 02 01 01 01 03 02 02 03 07 06 12 12 16 15 18 21 22 22 
01 02 00 01 00 00 00 00 00 02 01 03 03 04 05 07 07 07 06 00 01 00 01 02 01 03 01 01 00 06 05 10 14 14 15 17 19 21 22 24 
01 01 01 00 02 02 04 02 03 03 03 03 04 03 03 04 04 07 07 00 02 02 05 06 07 07 13 11 14 16 09 12 14 17 18 20 22 25 25 25 
01 01 01 00 03 02 03 03 04 05 01 04 03 04 03 05 06 07 08 01 02 05 07 10 10 10 10 16 16 17 12 12 18 19 20 21 24 25 26 26 
01 01 00 02 02 04 03 04 03 03 04 01 04 05 06 06 07 09 10 04 04 05 10 14 07 13 16 17 17 18 13 19 20 21 22 24 26 26 25 25 
00 01 02 03 04 03 05 02 04 05 03 05 06 05 06 07 08 10 10 04 08 09 14 15 15 15 19 19 19 17 20 20 22 23 25 24 26 24 25 26 
02 02 03 04 02 05 03 05 03 06 05 04 05 06 07 07 09 11 11 07 08 12 15 16 16 19 18 17 19 20 19 22 22 24 23 26 25 26 26 27 
02 02 02 01 03 03 04 05 05 06 05 07 07 08 08 09 10 11 11 10 11 13 16 16 17 17 16 18 18 18 21 19 22 22 22 24 27 28 30 31 
02 02 02 01 02 04 05 06 06 06 05 07 08 09 10 09 11 11 12 11 13 15 17 17 17 17 18 18 19 20 19 21 22 23 24 27 27 31 31 31 
02 02 01 02 04 04 06 06 06 07 08 07 09 10 11 11 09 12 13 13 14 17 17 16 16 17 19 20 20 21 20 21 24 26 27 28 32 32 32 32 
02 02 03 04 05 06 06 06 07 08 08 10 12 11 11 11 13 14 14 15 14 16 15 16 18 19 18 19 20 23 24 23 26 27 29 31 32 32 33 33 
02 03 03 04 05 05 06 07 07 08 10 10 10 12 11 12 12 14 15 15 16 16 18 17 18 17 19 22 22 23 22 25 27 28 29 31 32 32 34 35 
02 02 02 02 05 04 07 05 06 07 07 09 08 07 07 09 07 11 10 10 16 17 19 19 19 20 22 23 23 23 22 26 22 24 25 27 26 32 30 30 
02 02 03 02 06 04 05 07 08 08 08 09 07 08 07 09 11 10 11 12 18 18 19 20 20 21 23 23 23 24 23 23 25 25 25 26 31 30 31 32 
03 03 02 04 04 07 06 08 07 08 09 06 08 06 11 09 07 11 12 13 18 19 21 22 21 23 25 23 22 22 25 23 25 25 30 29 30 31 32 33 
02 04 05 07 07 06 09 06 08 09 07 08 05 06 08 08 09 12 12 15 19 21 24 23 24 22 23 23 22 25 25 27 25 26 29 30 30 32 32 34 
04 04 06 08 07 09 07 08 08 06 09 06 08 06 08 08 10 14 13 14 20 22 22 22 23 23 22 22 21 25 27 25 26 26 30 29 31 33 34 33 
05 05 06 06 07 07 07 09 09 07 07 09 10 11 12 10 13 15 15 16 20 22 21 20 20 22 21 20 19 25 26 22 27 28 28 31 36 36 39 40 
05 05 06 05 07 08 08 09 09 08 09 09 12 12 12 12 14 16 17 18 21 22 20 20 21 21 21 19 20 23 26 26 28 29 30 34 35 40 41 42 
06 07 06 06 08 08 09 10 10 08 10 15 13 13 13 15 16 18 17 17 23 19 20 18 18 21 17 19 19 27 23 29 31 35 36 37 42 43 44 44 
07 06 07 06 07 08 09 10 10 11 12 12 12 13 14 15 18 16 18 19 19 21 18 18 19 17 20 19 19 23 29 27 34 35 39 42 43 44 45 45 
06 07 06 07 08 08 09 11 11 11 12 13 13 14 15 18 17 19 20 20 22 18 19 19 18 20 18 19 18 28 25 33 36 38 40 43 44 44 46 48 
06 06 07 05 06 07 09 12 13 13 13 14 16 14 14 15 14 19 19 19 20 21 24 24 24 25 26 28 30 31 32 34 38 38 39 41 40 45 45 45 
06 05 06 06 07 09 10 13 12 12 14 16 14 15 14 16 17 19 20 21 21 23 24 25 25 27 28 31 33 34 34 37 39 39 39 41 44 45 48 49 
06 07 04 06 09 10 15 13 13 13 15 16 15 15 17 15 20 22 24 25 23 24 25 27 27 28 28 34 35 36 37 40 40 39 44 42 42 48 50 51 
07 08 09 09 12 13 12 12 13 14 14 15 15 14 16 20 19 24 25 27 25 25 28 27 28 32 32 34 36 39 38 39 38 39 42 45 45 48 50 61 
08 09 08 10 11 12 13 13 13 14 15 14 15 14 19 18 23 25 27 28 25 26 27 28 30 31 34 37 38 41 39 39 40 38 46 44 48 53 52 55 
08 09 07 07 12 12 15 15 17 18 15 19 20 21 22 23 24 28 29 30 27 29 31 33 34 35 37 41 42 43 40 44 47 50 51 48 51 61 62 63 
07 07 09 09 10 15 15 18 19 19 19 20 22 24 25 25 27 30 31 31 28 31 34 35 36 37 40 43 45 46 44 45 51 51 52 50 60 63 59 54 
10 08 07 11 13 15 17 19 20 21 21 22 25 26 26 26 30 31 32 33 31 32 36 38 39 39 41 45 47 48 46 52 53 60 61 60 61 59 54 55 
07 11 11 15 17 18 20 22 22 21 23 26 26 27 27 29 30 33 33 34 35 36 38 39 41 43 44 47 48 50 52 53 62 56 61 63 59 54 55 57 
11 10 13 16 17 19 20 20 23 23 25 25 26 27 29 29 32 33 34 35 35 37 39 42 42 43 46 49 51 51 52 55 54 62 63 58 65 62 57 58 
12 13 16 18 19 21 22 22 22 24 26 27 28 28 30 31 33 34 35 36 37 39 41 42 44 46 48 50 51 53 60 62 56 62 58 60 61 57 58 59 
