15 14 14 14 14 13 14 14 15 16 18 14 20 17 17 15 17 15 19 20 19 22 18 19 20 22 21 25 22 21 20 17 17 15 15 13 12 10 12 13 
14 15 14 14 14 14 13 16 17 15 17 19 17 17 17 18 14 20 20 21 20 19 20 21 20 21 25 21 21 19 18 17 15 13 13 11 10 13 13 13 
14 14 14 14 13 13 16 18 19 20 16 18 17 18 14 16 22 22 23 18 21 19 21 20 24 23 21 20 18 19 16 16 13 12 11 10 13 14 15 16 
14 15 14 15 14 14 16 20 21 19 18 17 18 17 18 17 19 24 27 18 20 22 20 22 22 22 22 18 16 17 16 14 12 10 12 13 12 16 18 19 
14 14 13 16 14 16 19 23 25 13 14 24 21 23 24 21 18 26 23 24 23 19 21 19 19 21 22 17 18 14 13 15 11 12 13 12 13 17 16 16 
13 15 13 17 19 19 21 26 27 18 19 21 24 25 25 21 24 23 23 21 21 21 19 17 17 20 18 18 18 14 13 12 13 14 14 13 17 16 19 21 
14 13 19 20 20 21 27 28 30 15 25 25 25 21 20 21 26 23 24 23 18 22 18 18 19 20 19 18 16 12 14 12 14 13 13 16 14 19 21 22 
14 19 18 23 24 27 27 30 31 27 23 28 21 22 20 22 20 23 23 18 19 16 19 18 19 19 19 17 17 14 13 15 12 14 15 15 19 20 21 24 
18 17 22 23 26 26 30 30 31 24 30 22 21 22 22 19 23 25 23 17 15 19 18 17 17 20 17 16 17 13 15 13 14 14 16 18 19 23 23 24 
20 18 21 19 15 17 14 19 16 16 24 24 25 26 27 26 31 28 31 18 20 16 23 21 20 18 23 17 19 20 12 16 15 17 18 20 19 22 18 17 
20 18 18 17 14 16 19 16 17 18 24 24 27 28 29 30 28 32 31 17 21 22 20 21 21 19 18 20 21 22 15 14 18 18 18 20 22 17 18 18 
17 19 17 15 19 16 15 17 18 19 24 29 29 30 26 31 34 32 30 23 19 23 22 25 16 21 20 22 21 21 15 20 19 18 22 21 17 17 15 15 
19 17 18 15 15 16 15 18 18 21 29 27 30 31 33 32 33 30 31 19 21 19 26 24 22 21 24 21 22 21 18 19 18 19 20 16 17 15 14 15 
18 19 14 13 14 14 17 20 19 19 26 30 31 34 32 34 31 30 31 20 18 23 25 24 22 24 21 21 23 24 19 19 18 20 16 18 14 16 15 13 
16 16 13 16 16 17 21 20 22 23 29 27 31 30 30 32 32 32 33 21 21 30 23 23 23 22 16 21 17 16 17 14 13 11 11 14 17 13 13 14 
14 17 14 15 19 19 20 23 25 26 31 29 30 29 29 33 32 34 34 25 21 26 23 24 25 21 20 16 14 13 14 14 11 12 12 14 14 14 15 15 
16 13 20 20 18 22 21 25 26 27 27 34 31 31 32 32 35 35 36 21 30 19 22 18 17 17 20 14 13 13 13 10 12 12 12 16 11 14 12 12 
14 18 16 21 22 24 27 27 28 27 31 28 31 31 33 34 34 38 37 29 22 29 20 19 15 15 11 14 12 13 10 11 12 12 13 12 16 11 13 13 
16 15 21 21 23 27 26 27 29 29 27 31 32 32 32 33 36 36 38 24 31 19 18 15 16 11 14 13 10 10 11 11 13 11 12 17 12 14 13 14 
18 18 16 17 19 17 15 13 14 14 15 16 17 16 16 17 17 21 19 19 22 21 21 21 21 20 21 19 18 18 16 17 15 15 16 15 16 15 14 14 
17 16 17 16 17 16 14 14 15 15 16 18 16 17 16 18 20 19 18 18 21 20 21 20 21 19 19 18 17 17 18 15 16 15 16 15 15 14 14 14 
18 16 18 16 16 13 12 16 18 17 17 14 17 17 19 18 21 18 18 18 20 24 21 20 19 20 19 17 15 15 15 18 16 15 15 16 17 14 12 12 
16 15 13 12 12 15 15 19 19 16 14 17 17 17 19 17 17 18 17 18 22 20 20 20 20 18 18 15 15 16 16 15 15 15 16 14 15 13 13 12 
14 13 13 13 16 14 17 19 21 16 17 16 18 17 17 17 18 18 16 17 20 21 21 22 18 19 16 15 13 16 15 15 15 15 13 15 14 13 12 12 
13 13 16 17 16 17 17 21 21 15 15 20 18 18 19 17 16 16 14 14 20 19 16 14 13 16 15 12 10 15 14 11 14 13 13 13 14 13 14 15 
14 14 16 18 20 18 20 21 21 17 17 18 19 18 18 17 16 14 13 13 17 18 13 14 14 15 14 10 10 13 13 12 13 11 11 13 13 15 15 15 
14 17 19 19 21 19 23 22 23 16 21 20 18 14 13 16 17 13 11 11 18 13 13 11 11 14 09 09 09 14 11 17 13 13 13 14 17 15 15 16 
18 19 20 21 20 23 21 22 23 22 17 20 14 14 13 14 13 11 10 11 13 15 12 12 11 10 11 10 09 11 14 10 13 13 14 16 15 17 16 15 
19 20 20 20 21 20 23 24 23 17 21 15 14 12 13 13 11 11 09 09 15 12 12 12 11 11 09 09 09 13 09 14 13 13 14 15 16 15 16 16 
19 17 18 19 13 14 15 15 13 13 17 15 15 13 13 12 13 11 12 12 13 12 13 13 13 12 11 11 10 10 12 13 14 14 14 14 15 16 15 15 
18 17 15 16 14 15 16 13 13 14 14 16 13 13 13 11 11 12 12 12 14 12 13 11 12 11 11 10 11 12 14 13 14 14 14 14 16 15 16 17 
16 17 21 18 15 16 13 13 11 11 15 13 13 12 11 12 13 13 13 13 12 16 12 10 12 11 11 12 13 13 13 15 15 15 15 15 16 16 17 18 
18 19 17 18 16 12 14 11 11 11 13 12 11 12 13 13 14 15 14 12 11 11 10 10 10 11 11 14 13 13 14 14 15 15 15 16 17 19 18 17 
19 17 18 16 13 15 11 12 10 10 12 12 14 14 13 14 13 12 14 14 11 11 10 10 11 11 12 13 12 13 14 15 15 15 16 16 17 17 17 17 
18 16 13 14 12 11 13 09 09 09 12 14 13 12 12 13 11 11 09 09 10 12 11 11 11 11 12 13 13 13 14 15 15 15 16 16 17 17 17 17 
15 16 12 12 12 09 11 09 10 11 12 13 12 12 13 12 12 09 10 11 10 11 11 12 12 13 13 13 13 14 14 15 16 16 16 16 17 17 18 18 
15 11 16 13 09 12 08 10 10 10 14 12 12 10 09 11 08 10 10 11 12 10 11 11 11 12 13 13 13 14 16 15 16 16 16 17 15 18 18 19 
11 11 08 09 10 10 12 10 10 10 12 13 09 10 10 09 10 11 10 11 11 12 11 11 11 12 13 14 14 14 14 16 16 16 16 17 18 19 19 19 
08 08 10 10 09 12 09 10 10 11 14 10 11 08 10 10 09 11 10 10 12 10 11 11 12 13 13 14 14 14 16 15 16 16 17 18 18 19 19 19 
09 08 09 10 10 11 10 11 10 11 11 10 11 09 09 10 10 10 11 11 11 11 12 11 12 13 14 14 14 15 16 16 17 16 17 18 19 19 19 20 
