61 55 61 57 61 61 64 57 62 62 61 62 61 56 57 63 67 65 66 67 67 69 68 67 67 69 66 71 69 69 69 70 71 71 71 72 73 74 73 73 
61 63 61 63 56 55 64 62 57 56 60 55 57 64 59 65 65 67 67 68 67 69 67 67 66 68 70 69 70 69 71 70 71 72 72 72 74 73 74 74 
61 61 66 65 62 65 61 62 61 61 61 56 65 66 63 67 69 68 66 68 69 66 67 66 71 68 69 70 70 70 71 73 73 73 73 74 73 73 73 73 
63 62 63 65 61 56 59 61 55 61 61 64 67 69 66 66 68 66 67 67 68 69 66 66 70 68 69 71 71 71 73 72 73 74 73 73 74 73 73 73 
56 57 62 60 68 66 58 62 62 56 64 54 66 58 63 70 70 68 69 71 69 71 68 69 69 67 70 71 71 72 72 72 74 73 73 74 75 73 73 73 
56 63 59 63 54 58 62 56 54 55 56 66 57 65 66 69 68 70 70 71 71 68 69 69 69 70 71 72 72 72 74 73 73 72 72 75 74 73 73 73 
59 57 59 55 55 62 59 61 60 67 57 56 65 67 68 69 71 71 71 68 69 70 70 70 70 71 71 72 72 73 73 75 73 73 73 74 72 73 73 73 
62 54 61 54 62 61 60 62 54 61 64 62 66 66 70 70 70 71 72 70 71 71 71 71 70 71 73 73 73 73 73 73 74 73 72 72 74 73 73 73 
54 55 65 62 54 60 61 59 59 63 55 59 69 68 68 70 71 72 72 70 71 70 70 70 71 73 72 72 72 73 73 73 72 72 72 74 72 73 72 74 
60 61 61 64 64 58 68 66 68 69 65 66 68 68 68 69 68 73 73 71 72 71 74 72 71 71 70 72 71 71 72 73 72 72 73 73 73 72 70 70 
60 62 62 58 66 66 66 69 69 69 66 67 68 68 68 70 71 73 73 71 72 74 71 71 70 70 71 71 71 72 73 72 73 72 73 70 73 70 70 71 
56 56 67 67 58 68 71 70 69 69 67 70 69 68 71 70 76 74 74 74 73 72 71 71 72 70 72 72 72 72 72 73 72 73 73 73 68 69 68 68 
57 65 65 68 70 69 71 70 70 68 69 69 69 69 71 72 71 73 74 72 71 71 72 70 70 71 70 71 72 74 73 73 74 73 72 69 71 69 68 68 
66 58 68 69 69 71 70 68 68 70 69 69 68 67 71 70 74 75 76 70 71 70 71 71 70 70 72 73 73 74 73 73 72 73 68 71 68 69 67 67 
66 66 67 69 69 69 68 69 69 69 69 71 72 73 74 73 75 76 77 70 70 76 73 74 75 72 70 73 71 70 72 71 70 70 70 68 69 67 67 67 
66 67 68 68 69 69 69 69 69 70 71 71 74 74 74 73 76 77 79 73 73 73 75 74 74 70 72 70 70 70 72 70 70 68 68 68 68 67 67 67 
67 67 71 70 68 68 70 70 71 71 71 74 74 75 75 77 76 79 79 70 76 77 74 72 71 71 72 70 69 69 70 73 69 67 67 68 67 66 58 58 
68 69 68 69 69 68 69 71 71 72 73 74 75 75 76 77 79 79 80 78 76 78 73 73 70 71 69 70 69 69 69 69 69 68 66 66 67 58 65 59 
68 68 69 69 68 69 70 71 70 72 73 74 75 76 77 79 79 81 81 76 79 74 71 72 71 69 69 69 69 68 69 69 67 68 66 67 65 66 66 59 
68 68 67 69 69 68 68 67 67 67 66 69 67 68 68 69 70 73 71 71 74 74 73 70 70 70 59 69 66 66 66 65 59 64 58 64 65 64 64 58 
67 68 68 68 68 69 67 67 67 68 67 67 68 69 69 70 72 71 69 69 74 73 70 68 67 67 68 66 66 65 65 59 64 64 64 56 59 58 65 59 
68 67 71 69 68 68 67 67 67 66 68 69 70 70 71 72 74 69 66 66 73 74 68 59 71 66 67 66 66 66 65 63 64 59 58 59 62 58 65 65 
68 68 67 67 67 66 67 68 67 69 69 71 70 71 72 71 69 66 66 66 71 69 66 59 59 66 63 59 59 64 57 65 59 59 64 58 66 66 66 59 
68 67 68 68 66 67 67 67 68 69 71 70 70 70 70 70 68 67 66 65 70 67 59 64 65 62 65 68 66 58 59 58 59 65 64 66 59 59 59 66 
67 66 69 66 66 66 65 59 58 70 69 67 67 65 65 67 69 66 66 67 68 69 67 68 69 59 67 67 66 58 58 59 65 59 59 59 59 66 66 67 
68 66 67 66 65 63 66 64 58 68 68 68 65 65 66 68 66 67 66 66 69 67 69 67 67 66 67 66 66 58 64 59 65 59 65 65 65 67 66 66 
66 68 58 58 67 59 62 63 64 69 66 66 66 66 66 68 70 67 66 66 68 71 68 67 67 67 66 66 65 64 59 67 66 66 66 59 70 67 66 66 
68 65 68 66 64 58 58 59 64 59 59 65 66 66 67 67 68 68 67 58 69 69 69 68 65 66 67 65 59 59 64 66 67 66 65 66 66 66 66 66 
66 68 64 64 64 64 63 64 63 66 58 66 67 65 66 68 67 65 59 65 69 68 66 59 66 67 65 66 59 59 66 66 65 65 66 66 67 66 67 66 
65 65 65 56 59 65 62 63 62 56 59 65 66 59 59 65 65 64 64 64 68 67 66 64 57 63 61 63 62 56 64 59 63 56 56 57 57 58 63 63 
59 57 65 56 63 64 57 62 57 63 64 66 59 65 65 58 65 64 64 65 65 68 57 57 56 62 63 62 56 56 57 58 56 63 62 63 59 57 64 64 
59 59 60 55 59 56 56 63 58 59 65 59 59 65 65 65 64 64 65 59 67 56 56 62 58 55 56 56 63 63 59 61 57 63 58 64 54 63 57 63 
57 60 62 60 55 62 56 59 64 59 66 59 67 66 58 58 65 66 65 65 56 57 57 55 55 62 55 62 63 65 62 64 63 57 63 55 57 62 63 64 
55 57 54 55 62 61 57 58 66 65 59 59 59 65 63 65 58 65 66 59 58 55 62 54 55 60 62 58 64 59 58 62 58 64 56 63 62 58 63 58 
54 60 63 64 56 63 57 57 56 56 64 67 66 66 67 64 64 65 59 59 56 66 57 64 59 63 62 59 58 64 62 57 62 56 56 56 63 57 57 57 
61 57 62 57 64 56 58 62 64 65 66 59 67 59 59 63 65 65 64 64 58 58 65 59 65 58 64 58 63 57 61 62 62 62 56 62 57 63 57 58 
61 57 59 63 58 64 60 58 64 58 66 69 66 59 59 64 66 58 64 58 66 64 64 62 56 57 66 57 57 57 57 62 56 56 62 58 63 57 63 57 
58 56 58 56 62 56 64 56 63 66 66 67 67 66 58 58 64 65 58 64 64 66 63 63 56 57 56 57 62 57 63 63 62 62 56 64 58 63 63 64 
61 64 56 62 62 58 56 59 57 59 67 66 64 59 64 58 58 58 64 58 67 63 63 61 63 56 63 63 62 62 57 56 62 56 57 58 63 58 57 58 
56 63 62 62 62 63 63 59 66 66 66 66 59 64 64 64 64 64 64 58 58 63 58 62 56 56 56 56 62 62 62 56 57 56 63 63 57 58 58 64 
