63 62 63 64 62 62 66 66 68 69 70 67 72 70 70 68 74 67 71 72 72 72 72 72 72 72 71 71 69 69 68 70 67 66 66 67 64 68 65 64 
57 63 56 64 64 58 59 69 69 68 70 71 70 71 72 70 68 72 72 72 72 72 72 71 71 71 72 69 69 69 68 68 66 66 65 59 68 64 59 65 
62 57 65 65 57 67 70 70 70 72 68 72 72 75 66 72 71 73 72 72 72 74 71 70 72 71 69 68 68 67 69 67 65 57 69 65 57 58 59 66 
63 59 59 67 66 68 69 70 71 72 70 71 76 76 68 72 73 72 75 73 72 71 70 70 70 69 70 68 67 67 67 67 63 63 66 59 59 66 64 64 
58 59 63 66 71 71 72 71 72 59 68 74 76 76 76 77 72 74 71 72 71 72 69 68 68 69 69 66 64 71 68 67 63 57 57 62 66 59 59 65 
63 65 67 67 68 72 72 73 75 69 72 76 76 76 76 74 74 71 70 72 70 71 68 68 68 68 68 64 65 69 65 58 63 63 63 58 65 65 67 68 
67 64 69 70 68 72 71 76 77 71 77 77 75 73 73 71 73 70 70 71 71 67 67 65 64 68 58 58 63 66 58 61 57 63 63 66 64 67 67 67 
65 69 67 71 73 73 75 75 77 78 74 78 75 74 72 72 67 69 69 70 66 68 58 59 65 64 59 62 57 57 55 57 57 63 58 58 68 67 67 67 
67 59 71 72 72 75 75 78 79 74 79 74 73 73 71 67 70 71 70 67 69 59 66 58 59 66 57 64 57 57 57 56 63 65 64 68 66 67 66 68 
69 68 70 68 68 69 70 71 69 68 74 74 72 73 73 72 76 73 73 66 67 65 68 67 67 65 68 64 65 66 56 63 62 60 54 56 65 64 62 62 
69 68 69 68 69 69 72 68 70 71 73 72 73 74 74 73 73 74 74 59 66 67 67 67 67 67 65 66 66 66 56 57 54 61 59 62 63 62 56 56 
68 70 66 68 71 72 67 69 68 68 73 72 74 74 72 75 76 74 72 68 66 69 67 68 64 66 66 66 65 59 64 64 60 59 58 61 57 56 56 57 
69 69 71 71 71 68 70 67 68 69 74 74 73 75 76 73 76 73 73 66 66 66 69 68 67 65 67 65 66 66 59 62 59 59 60 62 59 55 61 65 
69 71 69 71 68 71 67 70 67 68 73 74 76 77 73 76 73 72 71 66 59 68 68 68 66 67 66 66 66 68 62 58 60 58 65 59 61 58 63 57 
70 69 69 69 68 68 69 69 69 69 73 71 71 69 69 72 73 72 72 66 59 70 67 68 69 65 57 66 58 58 59 63 55 56 62 55 57 62 61 55 
69 69 68 69 69 69 68 69 68 68 71 72 69 70 70 72 72 73 73 68 66 67 69 67 67 59 65 64 57 63 60 56 56 62 57 61 63 61 56 63 
69 68 70 69 68 69 72 69 68 68 70 68 70 70 71 72 73 73 72 59 70 70 67 64 63 64 65 57 57 63 63 62 56 61 55 57 59 56 61 61 
68 67 67 67 68 69 69 69 68 68 68 69 70 70 72 73 72 71 72 71 67 69 58 58 62 56 56 57 56 63 61 58 62 56 55 60 63 54 61 62 
66 67 67 68 68 69 69 68 67 68 68 69 71 70 71 72 72 73 74 67 70 59 58 62 57 56 56 57 57 56 59 62 55 55 55 57 60 56 61 56 
67 66 66 66 66 65 60 56 59 65 63 54 63 63 64 54 61 62 65 64 59 66 65 58 58 58 62 65 59 59 66 64 66 57 62 62 62 61 56 62 
66 67 66 57 57 63 62 59 57 65 63 63 58 56 62 54 54 58 57 57 66 59 58 63 63 59 64 65 65 64 64 67 62 57 56 60 62 62 58 65 
66 65 67 57 59 65 61 63 63 62 65 54 62 61 56 63 61 57 63 64 65 58 57 63 59 57 59 66 68 68 65 61 56 57 56 56 54 64 66 67 
65 57 60 57 58 65 61 64 57 60 63 65 57 62 57 59 60 65 62 63 63 58 58 57 57 65 64 68 68 63 62 56 63 62 61 62 64 67 67 68 
55 55 64 57 63 61 64 64 57 57 65 57 60 60 64 60 63 57 56 54 58 63 62 57 65 63 67 68 69 56 56 61 58 56 56 63 59 67 68 69 
60 59 63 65 63 57 56 55 52 57 63 53 61 53 53 56 60 63 58 58 57 63 58 65 59 66 68 71 72 56 62 70 58 65 66 65 63 66 63 63 
55 65 60 64 63 61 56 52 52 55 61 55 53 54 60 57 57 64 65 54 64 64 59 67 68 68 69 73 73 66 58 66 66 67 68 62 67 63 64 65 
64 56 62 55 65 62 51 52 52 63 53 53 54 62 57 65 58 60 64 58 64 66 68 68 69 70 75 74 75 62 70 57 66 63 62 65 55 58 64 65 
61 62 60 62 53 52 53 53 51 52 54 52 62 56 64 59 61 58 65 65 66 66 67 69 71 73 74 77 76 70 64 71 63 58 56 62 57 58 64 66 
57 55 60 53 53 54 51 51 51 60 51 55 57 63 57 61 64 59 59 61 65 68 70 71 72 73 75 75 75 67 72 57 58 58 58 57 57 66 65 58 
62 56 55 56 64 57 61 61 55 55 61 55 58 63 57 64 63 58 57 63 66 59 59 57 63 63 60 63 55 55 64 65 62 55 55 56 60 56 60 54 
61 63 56 62 62 61 54 55 61 55 55 57 63 63 57 58 65 57 59 54 64 66 63 56 61 56 62 55 55 55 62 58 61 55 54 61 62 54 61 62 
57 56 57 56 56 54 57 56 63 63 56 60 64 58 59 64 55 59 54 55 65 57 61 60 64 61 64 62 57 63 64 54 55 60 57 55 61 61 56 62 
62 62 54 53 54 63 55 64 63 63 57 63 64 63 63 64 65 55 61 56 62 62 55 54 55 61 54 64 62 57 55 63 61 61 55 62 61 57 56 56 
54 54 54 60 61 54 63 62 63 64 57 57 63 57 65 65 59 61 56 62 57 54 54 65 55 59 56 56 57 56 57 60 55 65 54 60 55 62 56 55 
60 54 63 62 56 56 56 57 61 61 57 60 58 63 57 60 54 54 65 65 61 64 56 56 62 61 61 56 55 55 61 61 54 54 54 55 62 56 57 57 
61 54 62 62 63 62 63 61 62 63 57 65 63 65 54 65 55 65 54 61 62 56 56 62 57 62 56 55 60 54 61 55 54 55 61 62 56 63 56 62 
61 64 62 55 58 56 54 56 62 62 61 55 59 65 59 55 57 54 60 61 64 62 56 54 60 56 62 54 65 65 55 58 54 60 54 56 59 57 55 61 
58 55 58 56 61 55 55 60 55 58 63 61 65 59 59 64 60 60 60 56 57 58 61 61 54 55 60 58 58 54 65 61 65 54 61 57 63 61 62 62 
62 58 55 55 55 55 60 57 56 63 62 58 59 58 59 54 65 61 61 55 65 55 55 65 61 54 59 60 59 65 61 65 55 55 56 57 56 62 62 63 
61 56 55 61 55 55 55 63 64 58 60 65 54 65 59 60 60 55 62 62 62 55 56 54 60 59 58 65 59 59 54 54 62 55 62 62 62 57 56 57 
