04 04 05 04 06 06 03 05 02 01 01 04 02 03 04 06 06 09 07 06 06 05 06 06 06 05 09 05 07 08 08 11 09 09 10 12 10 15 13 12 
04 05 05 03 04 03 05 01 02 02 02 03 04 05 05 07 09 06 07 05 04 07 06 07 07 07 06 08 09 09 07 10 10 10 10 12 15 12 11 11 
05 05 03 03 07 03 01 02 03 01 04 03 05 05 08 08 07 06 06 07 05 04 07 08 04 08 06 09 08 08 11 08 10 09 15 12 13 11 11 11 
04 03 04 02 04 03 03 04 04 02 03 06 05 06 07 08 08 06 04 05 06 07 09 10 05 07 09 08 11 08 09 11 09 10 14 12 12 11 08 08 
06 04 07 05 00 01 02 04 04 07 07 05 07 06 06 07 08 06 06 04 06 08 10 08 08 12 09 10 09 14 13 12 11 11 11 09 11 10 10 10 
06 06 03 04 05 01 03 04 04 06 06 06 06 05 05 06 06 06 06 06 06 10 08 10 11 10 10 09 09 13 12 11 11 09 09 10 09 10 08 08 
03 05 04 03 06 03 07 04 03 07 05 08 05 05 05 07 08 06 05 08 10 08 10 08 08 09 09 09 10 12 11 13 10 08 08 11 13 09 07 07 
05 02 05 03 03 05 04 03 03 05 05 04 05 05 06 07 07 05 05 10 08 10 07 08 09 09 08 10 10 11 10 09 08 08 08 09 10 08 07 06 
02 06 03 02 04 04 04 03 02 03 03 05 06 05 05 07 05 05 06 08 11 08 10 07 09 08 09 10 09 09 09 09 08 08 08 10 08 07 06 06 
03 04 03 05 07 06 03 04 03 03 04 04 03 01 01 02 00 04 03 08 07 08 05 06 06 06 09 08 08 08 09 08 11 12 12 10 15 10 12 13 
03 04 05 04 05 05 03 03 03 03 02 04 01 02 00 01 03 03 02 08 05 06 06 07 07 05 09 08 08 09 10 10 12 12 13 13 10 13 13 13 
05 04 07 05 05 02 05 04 04 04 04 00 01 00 03 01 06 03 03 06 07 04 08 09 07 10 05 07 06 06 08 14 13 14 09 13 13 13 13 13 
04 03 01 01 02 04 01 03 03 05 01 02 00 00 02 03 01 03 02 06 06 09 09 10 09 05 09 06 06 06 12 11 15 15 14 12 16 15 15 12 
02 01 01 01 01 01 03 04 03 05 03 00 01 01 03 00 03 03 03 06 08 08 09 10 06 10 05 07 06 06 10 14 15 15 12 16 14 12 14 14 
01 01 06 04 03 03 02 05 04 04 01 03 02 02 02 02 02 03 02 07 06 03 04 03 03 05 08 07 08 09 12 14 13 12 12 13 11 11 10 10 
03 02 04 04 04 04 04 04 02 02 01 02 02 02 02 02 02 02 01 05 06 04 03 04 04 08 06 09 08 08 12 13 12 12 12 11 12 10 11 11 
02 07 02 02 07 03 07 03 03 03 03 01 02 01 01 02 04 01 00 06 03 04 04 05 05 07 12 10 09 09 14 12 11 11 11 11 08 10 11 12 
07 03 07 04 03 05 02 05 03 02 00 04 02 02 01 03 01 00 00 02 03 02 04 05 07 08 09 09 09 09 11 13 13 11 10 08 10 11 11 13 
05 08 02 03 04 02 04 02 02 01 04 01 01 01 01 01 01 00 00 03 01 04 06 05 07 09 09 09 09 10 14 11 10 10 09 09 10 12 12 12 
04 03 06 05 03 05 04 09 06 06 06 05 06 05 05 04 08 05 08 09 03 04 04 02 02 03 01 04 02 01 00 04 02 03 04 06 05 08 05 04 
05 04 04 04 03 05 08 06 06 05 06 06 05 07 06 06 05 09 09 09 04 04 02 02 01 02 04 01 02 02 02 02 04 04 04 04 09 04 06 07 
03 05 05 04 08 06 06 06 05 07 05 05 07 08 04 08 09 10 08 08 04 02 02 01 04 02 01 02 02 00 03 04 05 05 08 07 02 05 04 04 
06 05 06 05 06 05 04 04 04 05 06 06 06 08 09 08 11 08 10 09 02 03 01 01 01 00 01 02 02 04 03 06 06 06 06 03 05 04 04 05 
04 06 04 04 04 04 04 07 05 05 05 07 10 10 09 11 09 09 09 12 03 01 01 00 00 00 01 04 03 05 06 05 05 07 04 05 03 06 03 03 
05 04 04 04 04 04 07 06 06 06 06 08 08 07 07 09 08 09 09 09 01 05 01 01 01 01 01 02 00 04 03 02 03 03 03 03 06 05 06 07 
04 04 04 04 04 06 06 06 08 07 07 08 07 08 09 07 10 09 10 11 01 02 01 02 03 01 02 00 01 03 04 02 03 03 03 06 04 07 06 06 
04 03 04 05 05 08 05 08 08 07 08 08 08 08 08 09 07 10 10 11 04 01 02 01 01 02 01 01 00 03 01 05 04 05 05 06 08 07 06 06 
03 04 04 05 07 08 10 08 09 08 08 09 08 08 08 08 09 09 10 13 03 05 03 02 00 00 01 00 00 02 04 02 05 05 06 07 08 07 07 06 
05 04 05 06 07 10 08 09 09 08 09 08 08 09 08 08 09 12 12 13 05 01 01 01 01 01 00 01 00 04 01 05 05 05 06 08 07 06 06 07 
04 06 05 06 13 11 07 08 07 07 07 09 08 09 10 11 10 12 10 09 04 03 05 05 05 04 09 06 07 08 03 04 06 07 07 07 09 07 06 06 
04 06 09 08 10 10 07 07 07 07 08 07 10 09 10 12 12 09 08 08 03 05 05 06 07 07 06 08 08 08 05 04 07 07 08 08 08 06 07 07 
08 07 07 07 10 06 09 08 09 10 09 11 10 10 12 11 12 08 08 08 04 05 07 09 04 08 09 08 06 06 04 10 08 08 07 09 05 06 04 04 
06 05 04 04 05 08 05 09 09 11 11 11 11 11 11 09 09 10 07 06 06 06 09 09 09 07 10 07 07 06 07 07 09 09 08 06 08 04 05 05 
04 04 04 05 06 04 09 10 10 11 11 11 09 10 09 09 08 07 07 04 05 08 10 10 07 10 07 06 07 07 06 09 08 09 06 08 05 06 05 05 
04 04 13 09 07 08 06 09 07 06 10 07 07 05 04 07 08 04 05 05 06 08 07 06 06 07 05 05 03 03 06 07 06 05 05 05 05 04 03 03 
08 05 10 09 09 06 09 06 06 07 09 07 04 04 05 06 06 05 05 06 05 07 06 06 06 06 06 03 03 04 07 06 05 05 05 04 05 03 03 04 
05 14 05 05 14 08 07 06 06 06 06 05 04 05 05 07 03 05 03 03 08 07 05 04 04 05 03 03 02 02 07 05 04 03 03 05 02 03 03 03 
14 07 14 08 05 06 05 07 05 06 05 04 06 05 05 05 06 03 04 04 06 07 05 04 03 02 02 01 02 04 04 06 04 04 03 03 04 04 03 03 
10 16 05 05 07 05 05 06 04 04 04 05 05 05 04 07 03 05 05 05 08 04 04 03 03 02 02 04 02 03 06 04 04 02 03 04 02 03 02 03 
08 10 06 05 05 05 05 04 05 04 04 05 04 05 05 05 04 06 04 05 05 04 04 02 02 02 02 03 04 04 05 04 04 03 03 03 03 03 03 03 
