78 77 78 79 77 77 77 79 79 79 80 77 81 79 78 77 78 75 76 76 76 73 76 74 74 72 73 69 70 71 69 75 70 72 73 76 72 80 74 73 
78 79 77 77 77 78 78 79 79 78 79 80 78 78 78 76 76 76 76 74 74 75 74 73 73 72 69 71 70 73 73 70 73 72 72 75 79 73 72 72 
77 78 80 78 78 77 81 80 80 81 78 79 78 78 76 77 75 76 76 77 74 76 73 73 70 71 74 71 70 68 73 74 73 71 80 76 75 70 68 68 
78 78 78 77 79 80 79 81 81 80 79 78 78 77 75 75 77 77 78 76 74 73 74 72 72 70 70 70 70 71 71 74 71 72 77 76 73 68 58 63 
79 78 77 77 77 78 81 81 82 76 76 83 79 79 79 78 74 76 73 71 71 76 74 73 73 72 68 68 59 79 77 70 70 67 67 69 73 65 66 67 
78 79 77 77 78 79 82 82 85 79 77 80 79 79 79 75 76 72 72 73 73 74 73 72 72 70 69 64 58 74 72 71 67 65 65 69 67 67 67 67 
78 77 78 79 79 82 80 85 86 77 83 78 78 75 74 74 72 71 71 72 76 75 71 68 67 67 64 57 57 75 68 69 66 65 65 71 65 66 58 63 
77 77 78 81 81 81 85 85 86 83 77 83 77 76 72 72 70 72 70 77 71 74 70 68 59 57 63 65 63 66 67 56 64 64 67 66 70 58 59 57 
78 77 80 81 82 85 84 87 88 80 84 76 74 73 73 70 70 71 69 71 76 69 67 66 65 57 63 63 63 66 56 59 66 59 59 71 65 58 64 59 
78 78 78 77 80 79 78 77 75 75 76 75 71 69 69 69 68 69 67 71 69 69 65 66 67 66 68 59 58 64 66 58 68 66 66 65 68 65 68 69 
78 79 79 79 79 77 78 75 74 74 75 73 69 69 68 68 68 66 58 70 68 66 67 66 67 59 66 58 59 59 64 68 66 67 67 65 66 69 70 70 
79 78 77 77 79 77 77 74 72 71 73 69 69 67 69 68 70 59 56 67 67 68 67 67 66 67 56 64 57 63 66 66 67 68 65 67 67 70 72 73 
78 76 77 77 77 75 73 71 71 72 68 70 67 67 68 66 58 62 55 67 67 68 69 68 66 57 66 57 57 57 67 66 68 68 68 68 71 73 73 73 
76 77 76 77 75 74 72 73 71 71 70 67 68 67 59 58 63 56 62 67 68 68 67 69 58 66 62 64 58 63 59 67 69 68 68 71 71 72 75 75 
76 75 79 78 73 72 71 71 69 68 67 66 64 56 62 57 63 60 59 67 66 55 55 61 55 57 59 64 65 65 67 73 70 70 70 71 69 73 71 71 
77 76 76 75 75 71 71 68 66 66 59 59 56 55 61 61 55 59 65 58 63 56 61 61 61 59 64 65 66 67 68 71 70 72 73 70 72 71 71 71 
74 78 77 73 74 70 72 67 65 65 59 57 55 59 65 62 57 58 64 65 54 60 55 63 58 65 66 67 67 67 74 68 72 70 70 70 71 71 72 73 
78 74 75 71 68 69 67 67 59 57 63 62 60 59 65 57 60 65 64 59 54 59 63 63 66 66 68 66 68 69 70 75 70 71 70 71 70 74 72 73 
74 77 71 68 68 67 66 58 64 56 62 60 54 54 64 54 57 57 56 60 64 62 58 66 65 68 67 68 69 70 76 70 71 71 72 69 71 72 72 72 
73 72 72 70 69 69 67 69 66 66 64 58 61 61 61 54 55 55 62 57 54 62 63 57 57 64 62 66 64 63 57 59 65 67 68 69 69 70 69 69 
72 71 70 68 68 68 69 66 65 59 62 56 55 55 55 55 60 63 61 61 63 56 57 57 62 63 66 57 58 64 59 58 68 67 68 68 71 69 70 70 
71 71 68 67 70 68 68 64 56 57 63 54 55 55 54 55 65 56 61 55 57 65 63 55 66 63 57 58 64 63 59 70 68 67 70 70 66 69 69 69 
70 69 69 66 67 65 63 56 55 62 55 62 57 56 56 63 56 62 56 61 63 57 62 56 56 62 62 58 64 67 67 68 67 68 69 66 69 68 69 71 
69 69 66 66 58 58 56 57 61 55 62 61 61 56 55 62 62 55 56 62 63 56 56 61 55 62 63 65 64 66 68 68 67 68 67 69 68 71 69 70 
68 66 67 64 57 62 62 54 65 61 61 57 54 60 60 56 63 63 65 66 56 64 63 64 58 62 64 64 64 67 67 59 66 67 68 68 71 71 72 73 
67 59 65 58 55 62 55 65 64 59 60 59 60 60 60 57 56 66 65 65 56 63 64 57 63 64 58 58 58 66 66 66 68 68 68 69 71 73 74 74 
65 65 55 54 55 55 59 64 62 61 57 62 61 63 64 63 67 66 67 68 64 66 58 56 55 59 58 58 64 67 59 68 69 70 71 72 72 74 75 76 
64 61 55 64 58 58 65 57 62 57 54 58 57 63 65 59 66 68 68 68 65 64 55 62 56 57 59 65 64 65 67 67 70 70 72 73 75 76 76 76 
56 56 64 64 58 65 56 62 61 59 57 62 63 57 58 66 67 67 68 69 58 63 62 62 63 59 64 64 65 67 66 69 70 71 72 75 75 75 75 77 
54 55 54 59 59 57 63 55 62 62 60 62 56 64 59 66 68 70 70 70 66 64 67 64 58 58 63 59 65 65 67 69 69 69 69 71 69 75 73 72 
54 60 62 56 58 62 55 56 56 57 63 56 65 66 66 68 69 70 69 69 59 68 64 58 57 64 65 59 67 68 68 69 69 69 69 72 73 72 73 73 
56 61 59 61 56 61 57 57 57 58 57 65 66 67 67 69 72 69 68 68 66 57 58 57 65 63 64 68 70 71 70 69 69 69 73 71 75 73 73 74 
54 54 54 55 55 62 62 57 58 59 59 66 67 68 70 70 69 68 68 68 57 63 63 62 63 65 66 69 71 74 69 70 70 69 71 72 71 73 73 75 
54 60 54 62 57 62 63 58 59 66 66 67 67 68 69 69 69 68 68 68 57 62 58 57 58 65 69 72 73 75 70 69 69 70 72 70 73 74 74 74 
54 60 59 65 62 57 56 64 63 63 66 59 67 65 65 68 69 68 68 68 57 71 67 69 70 68 68 73 71 70 69 71 72 72 73 72 74 74 74 74 
56 58 63 58 66 61 58 57 57 58 65 67 65 66 66 67 68 68 69 69 65 68 70 71 72 69 72 70 71 72 72 71 73 72 72 72 74 74 75 75 
55 65 66 64 66 63 63 57 63 63 66 59 66 66 67 69 67 69 69 69 72 67 71 70 70 70 71 72 72 73 72 76 73 72 72 75 75 75 74 74 
66 58 66 57 62 58 62 63 63 64 64 65 66 66 68 68 69 68 69 70 70 76 71 71 69 70 71 72 72 74 73 73 73 73 72 73 75 73 74 75 
58 67 57 62 57 62 57 64 57 63 65 59 67 66 67 69 68 69 69 70 77 70 70 70 71 70 71 73 72 72 73 73 72 72 73 75 74 75 75 76 
58 58 56 56 57 62 63 63 64 58 59 66 67 68 68 69 69 70 70 71 73 71 72 69 70 71 72 72 73 73 73 73 73 72 73 74 74 76 75 76 
