09 10 09 10 15 13 13 11 14 15 18 19 24 23 23 25 23 30 30 30 28 33 28 28 29 33 26 36 30 28 27 24 23 22 22 19 23 16 20 22 
09 10 12 12 14 13 11 15 17 17 19 23 23 23 23 26 28 30 30 31 31 29 29 28 27 30 35 28 27 26 24 24 22 22 22 21 17 22 23 24 
12 10 11 12 12 12 14 19 22 21 22 24 23 23 28 25 32 32 35 27 32 30 28 26 37 30 31 27 26 26 23 21 22 22 17 20 20 25 27 28 
11 11 11 10 13 15 16 23 27 22 24 24 23 23 30 30 29 36 36 28 29 30 25 25 34 30 28 26 22 23 22 22 23 23 18 22 23 28 32 33 
09 09 15 15 12 16 18 25 26 24 23 33 26 29 30 26 28 33 32 37 33 29 26 26 26 23 28 24 25 20 21 21 22 24 25 26 27 33 34 35 
12 12 13 18 20 18 24 27 31 28 25 28 30 32 33 27 33 32 34 33 31 26 26 23 23 25 24 26 25 20 22 22 25 27 28 27 31 35 37 38 
10 15 16 18 25 23 23 31 35 23 32 26 32 30 29 32 30 33 34 30 25 29 24 24 25 27 27 25 23 22 22 22 28 30 31 29 35 38 41 43 
17 18 22 23 24 27 30 34 35 33 29 37 29 32 30 33 34 34 34 25 27 23 26 25 24 25 28 24 24 22 25 26 28 31 34 37 36 41 42 45 
19 22 22 23 28 28 32 36 38 32 38 30 31 32 34 34 33 35 35 26 22 26 24 24 24 29 24 22 23 26 25 28 32 33 36 34 40 43 44 46 
20 18 22 23 15 19 24 29 29 30 33 32 35 34 34 34 36 36 39 25 29 25 35 33 33 31 38 31 35 37 25 31 27 29 30 34 28 39 34 33 
21 21 18 22 19 24 27 30 30 31 33 35 34 35 35 35 35 40 42 25 28 33 33 35 35 33 32 37 38 39 28 28 30 30 29 32 38 33 33 34 
17 21 25 24 23 28 30 30 28 27 34 33 36 37 34 36 39 43 46 33 29 32 35 38 29 36 37 40 40 41 31 30 30 27 39 33 33 32 33 34 
23 25 27 28 30 28 31 27 28 28 33 34 36 36 37 40 43 47 48 28 33 31 37 37 38 39 43 42 43 40 29 32 27 28 31 32 29 33 31 35 
24 26 28 27 27 31 28 29 28 28 34 35 38 36 41 42 45 46 49 32 29 35 40 40 41 43 41 39 43 44 33 28 27 27 30 28 31 35 31 30 
26 26 18 19 28 28 33 31 35 37 36 40 42 43 44 44 44 49 48 33 35 46 41 41 41 42 34 39 34 32 29 27 30 30 30 31 37 34 36 37 
22 24 23 23 22 31 30 37 38 38 40 41 44 46 47 43 48 48 51 39 37 43 41 43 44 36 39 32 32 33 28 29 30 30 31 33 34 37 37 37 
27 18 21 27 24 33 38 39 40 41 42 44 47 47 48 47 46 52 54 37 48 39 41 36 34 35 33 32 33 33 27 31 31 33 34 37 39 38 37 37 
17 23 21 30 36 38 40 42 43 41 44 48 48 49 48 50 50 52 60 49 41 48 37 37 32 31 29 33 31 34 31 29 32 33 36 37 41 39 39 36 
22 18 30 35 35 39 41 40 43 45 47 47 48 49 50 49 52 62 61 43 51 37 36 34 33 29 31 34 31 30 28 32 34 35 36 41 39 36 39 38 
25 26 29 31 29 32 33 38 37 37 37 38 40 40 40 40 41 40 39 39 40 37 38 36 36 34 36 31 31 32 29 33 27 30 31 32 31 34 29 28 
27 29 29 31 31 33 37 37 38 37 39 39 40 40 40 41 41 39 40 41 38 38 36 36 36 35 32 32 30 32 31 28 31 30 31 32 34 28 26 26 
27 30 33 33 35 36 36 38 37 38 38 43 41 41 40 41 40 40 39 39 37 37 36 35 32 34 34 30 27 27 31 32 31 29 34 33 29 25 22 21 
31 34 34 36 36 36 37 36 37 39 41 40 42 41 41 39 40 39 39 40 35 34 34 34 34 31 32 27 28 32 30 33 30 31 31 26 26 22 20 20 
33 34 35 34 36 37 36 39 37 39 39 41 41 42 39 40 39 40 39 40 34 34 36 35 30 33 29 28 27 31 33 31 29 31 26 27 22 22 19 17 
34 34 33 35 36 36 39 39 40 40 39 41 38 38 38 39 39 39 38 38 33 36 31 29 29 29 25 24 20 31 29 23 22 19 19 21 25 18 19 20 
33 36 34 36 37 38 38 40 40 40 39 40 38 39 39 37 39 38 38 38 33 33 29 28 28 26 26 19 19 27 26 23 19 18 18 21 20 20 19 19 
35 34 38 38 36 39 41 41 41 39 41 35 38 37 37 39 38 38 38 38 35 28 27 23 22 24 19 19 18 27 21 20 19 19 20 23 20 19 17 16 
34 37 35 37 39 40 41 41 41 40 37 40 37 37 37 37 38 38 38 38 28 31 24 23 21 19 19 18 17 19 20 16 19 18 21 21 22 18 18 15 
36 34 38 38 39 41 41 41 42 39 40 36 38 38 37 38 38 38 38 38 33 24 23 20 20 19 17 18 15 18 16 18 20 18 19 23 18 16 16 17 
36 38 36 38 47 44 47 41 42 42 36 37 34 33 33 34 27 32 27 26 25 24 22 20 19 18 15 16 15 15 19 17 21 20 20 19 23 19 20 21 
36 38 41 42 47 44 42 42 42 42 36 35 33 30 30 29 32 26 26 26 24 22 19 18 17 17 16 15 15 15 18 20 20 21 21 20 19 21 21 22 
41 38 41 44 42 44 43 42 42 42 36 36 30 27 35 28 27 25 25 25 23 22 18 16 18 15 16 16 17 18 18 21 21 22 18 22 22 22 22 22 
38 42 40 43 44 43 45 44 43 40 31 31 28 26 26 26 22 24 23 26 19 19 18 16 14 15 14 18 17 18 20 19 22 22 23 22 24 24 23 21 
40 39 44 47 43 45 43 41 41 42 32 28 26 24 24 21 24 26 23 22 19 17 15 15 15 13 16 17 18 17 18 21 23 24 23 24 22 21 22 23 
42 42 50 46 43 42 37 39 35 34 27 29 25 25 25 23 25 23 22 22 17 16 16 17 17 15 17 18 19 20 20 24 23 23 23 22 19 22 20 19 
46 43 46 45 43 38 39 34 32 31 28 26 25 24 24 24 24 22 22 22 18 15 17 16 16 18 17 20 20 20 22 23 23 22 22 21 21 19 18 18 
42 50 43 39 44 36 37 31 29 28 27 26 24 22 22 25 23 21 20 20 15 20 17 18 19 18 22 21 21 21 24 24 22 20 20 19 24 19 19 19 
50 41 46 37 33 33 29 28 27 29 26 26 24 23 21 22 23 22 20 18 17 17 20 19 18 20 20 21 21 21 22 24 21 20 19 20 17 20 18 19 
41 49 36 33 33 29 29 29 26 25 26 23 22 21 22 24 20 19 18 18 16 19 17 19 19 20 21 20 22 21 25 21 20 19 19 17 19 18 18 17 
40 40 34 31 30 28 27 26 27 25 24 23 23 21 21 21 20 19 17 17 18 19 18 19 20 20 21 21 21 22 22 20 20 18 18 17 18 17 18 18 
