34 40 39 41 34 39 46 41 43 44 45 43 46 44 44 43 46 42 44 45 44 44 43 41 41 41 39 41 33 33 39 32 33 37 37 31 38 31 31 32 
33 33 39 42 43 41 42 44 46 43 45 46 44 45 45 45 43 45 45 44 43 43 41 40 40 35 41 33 33 32 32 33 31 32 37 32 31 32 33 40 
34 39 44 45 39 45 42 46 44 47 44 43 45 46 42 45 45 46 46 44 44 42 34 32 42 39 33 40 34 40 39 30 38 38 31 38 30 33 34 40 
42 42 42 45 40 44 47 44 47 45 44 45 46 46 43 44 46 46 47 43 42 42 32 31 40 40 34 34 40 32 39 39 38 32 36 33 39 40 41 42 
33 42 33 42 52 51 50 50 51 42 43 49 47 46 46 48 44 45 42 44 42 42 38 32 38 38 34 34 34 38 38 40 40 41 35 34 39 41 34 40 
39 42 45 46 45 50 49 52 51 45 45 48 46 47 48 45 46 41 41 43 41 39 32 39 34 38 41 40 35 33 40 39 35 35 35 38 41 34 41 42 
45 42 46 48 45 49 54 52 53 45 51 44 46 43 43 44 41 35 41 40 40 32 39 33 33 41 32 35 42 38 34 44 42 35 41 34 34 41 35 42 
42 46 44 48 51 51 51 54 54 50 46 50 44 44 42 41 34 35 40 40 38 34 38 39 40 40 43 43 43 42 42 42 43 42 34 35 41 35 42 43 
45 43 48 51 49 50 54 53 54 47 52 44 44 43 42 34 34 42 34 31 40 32 40 39 35 43 41 42 42 43 42 42 34 42 35 34 41 43 42 43 
46 45 46 43 42 43 35 44 42 41 45 44 44 44 44 43 45 42 42 38 38 33 39 37 37 32 37 40 34 40 35 42 42 42 42 42 42 43 42 42 
46 43 44 43 41 42 43 41 41 35 45 44 44 44 44 43 43 42 43 38 30 40 37 38 31 38 33 34 34 40 42 41 42 35 42 43 43 42 42 42 
44 45 34 40 44 42 43 35 34 34 44 45 45 45 42 44 42 43 43 33 33 41 38 32 39 32 34 34 34 40 42 45 42 41 43 42 43 42 42 42 
44 34 43 42 42 41 34 34 40 41 44 44 46 46 44 43 45 44 44 38 31 33 33 38 38 33 39 33 34 42 35 42 42 42 42 42 42 42 42 43 
34 44 34 35 40 40 34 41 39 34 44 45 45 45 44 45 43 43 43 31 39 37 32 38 32 32 34 35 40 42 42 42 35 35 42 42 42 42 42 42 
35 34 33 33 34 40 42 34 40 40 43 43 43 42 42 43 42 42 42 31 31 34 39 40 34 34 40 41 41 35 41 35 42 42 43 42 43 42 35 41 
40 38 33 33 39 34 35 34 41 42 43 43 42 41 35 42 42 42 42 32 39 39 34 40 35 34 35 35 35 42 42 35 43 42 42 35 43 35 42 43 
34 33 39 33 39 42 32 35 35 41 42 46 42 41 41 42 41 42 35 32 41 35 35 34 40 41 34 41 42 42 41 45 42 43 43 43 33 42 43 44 
32 39 38 39 34 34 43 42 42 35 44 41 35 35 35 35 35 40 41 35 42 42 41 35 34 41 42 43 42 42 43 42 45 43 42 42 44 44 44 44 
38 32 33 40 40 43 41 41 41 42 41 42 41 35 35 41 35 43 42 35 42 35 34 39 35 42 41 42 42 42 35 43 42 43 42 44 42 44 43 44 
38 32 38 36 38 32 33 32 30 30 40 37 31 39 40 35 41 32 35 35 41 35 41 42 43 42 47 44 46 47 47 46 49 49 50 48 52 47 48 49 
32 36 38 37 38 32 39 36 36 36 35 32 34 34 40 41 32 35 35 41 42 35 43 44 45 45 44 47 47 46 46 48 50 50 51 48 48 49 49 50 
38 38 41 31 32 39 31 41 39 32 41 33 34 40 37 31 35 34 40 34 35 42 45 46 42 47 46 47 46 48 47 50 50 51 47 50 48 49 48 48 
37 36 32 32 32 34 36 39 38 41 41 36 34 41 30 34 35 41 33 33 42 44 46 47 48 47 50 47 48 47 48 48 51 51 50 49 52 49 50 48 
37 38 37 33 36 37 39 39 36 40 36 40 40 41 41 35 39 40 32 31 43 45 48 49 48 50 47 47 47 49 47 50 52 53 51 52 49 49 49 50 
37 30 38 36 34 33 38 36 27 41 40 28 37 28 28 39 31 32 34 41 44 43 47 47 47 48 48 49 49 48 48 51 49 48 48 50 47 48 46 45 
37 35 36 41 38 32 37 27 26 37 37 31 28 29 29 39 34 41 31 32 46 45 47 47 47 49 48 49 49 49 48 50 48 48 49 47 48 45 45 46 
41 31 40 37 37 37 28 25 23 34 27 28 29 32 33 30 32 31 37 37 44 49 48 49 50 48 52 51 51 49 51 47 48 47 47 47 46 46 47 47 
36 32 33 29 26 25 26 22 22 26 28 26 32 32 41 40 33 36 38 38 47 46 50 49 50 52 50 52 52 51 47 50 48 47 46 45 45 48 46 47 
32 34 28 27 25 27 23 24 23 27 25 37 39 39 34 39 36 32 40 41 45 49 49 50 50 49 52 51 52 48 51 47 47 46 46 45 46 46 46 45 
37 32 30 36 36 34 38 30 31 38 29 31 32 38 38 34 31 36 35 41 46 47 44 43 43 44 42 45 44 44 47 46 47 46 46 46 46 45 45 45 
30 36 39 37 34 33 36 38 38 38 36 38 32 38 37 38 30 35 36 36 45 46 43 43 42 44 44 44 43 43 47 46 46 46 46 46 46 45 46 46 
33 37 31 37 32 36 39 39 40 41 32 32 32 38 30 39 39 30 38 39 46 41 43 43 45 43 45 43 43 43 46 49 46 45 46 46 43 46 46 46 
36 29 29 29 36 33 32 40 41 36 38 33 33 38 38 34 33 37 37 35 43 45 44 43 43 43 42 43 43 44 46 45 45 45 45 43 46 46 46 47 
36 29 29 36 37 37 40 40 36 31 33 38 31 32 33 32 30 33 39 39 45 42 42 43 43 41 43 44 42 43 45 46 46 45 44 46 45 47 47 47 
29 36 35 39 39 34 38 30 35 41 38 36 40 35 35 35 31 32 31 31 42 43 43 43 44 42 44 44 44 44 44 46 45 46 47 45 46 48 48 49 
32 31 34 33 35 35 35 35 35 35 33 35 35 36 37 41 39 31 40 41 43 42 44 42 42 42 44 44 45 45 46 45 47 46 46 46 47 49 48 48 
31 30 38 39 32 40 31 35 36 30 31 40 31 36 30 33 35 39 33 40 42 45 43 42 42 44 44 45 44 44 45 48 47 47 47 47 51 49 49 49 
36 40 31 35 40 30 33 30 35 37 36 39 36 31 37 31 40 33 40 41 43 42 41 42 43 43 45 44 45 45 46 47 47 47 47 48 48 50 49 49 
40 32 39 40 41 39 35 30 35 36 33 36 31 37 32 40 38 35 41 41 42 42 43 42 43 45 44 45 45 46 47 47 46 46 47 48 49 49 49 49 
40 41 34 34 41 34 35 35 37 37 32 31 38 37 32 34 34 35 41 42 42 42 43 43 44 45 45 46 45 46 47 47 47 47 48 48 49 49 49 50 
