11 10 11 12 10 10 11 11 09 09 07 09 06 07 07 07 08 08 07 07 07 09 09 07 07 09 06 11 09 09 10 11 13 12 12 13 11 16 15 15 
11 10 10 11 10 10 12 09 09 09 07 06 07 07 07 07 09 07 08 08 08 09 07 08 06 08 10 09 11 10 10 13 12 12 11 14 15 15 15 16 
10 11 13 12 11 11 10 08 07 06 07 07 07 07 08 08 05 08 08 08 09 07 07 07 11 08 08 11 13 12 13 12 12 12 15 13 18 16 17 18 
11 12 11 12 10 10 10 07 05 06 08 07 07 08 06 06 09 09 09 07 09 09 07 06 09 09 11 14 15 12 12 13 12 11 16 15 15 18 18 18 
12 12 11 11 12 10 09 05 04 09 09 04 07 07 07 09 11 10 12 11 09 12 08 10 11 08 12 14 14 14 13 17 13 14 14 13 14 17 17 17 
11 10 11 10 08 08 07 04 03 06 08 06 07 07 07 10 10 13 13 11 09 09 11 11 12 11 14 15 17 15 13 14 14 15 16 14 16 17 17 18 
12 11 11 09 06 07 03 02 02 09 04 08 08 10 11 11 13 14 15 08 10 10 12 13 13 14 11 17 18 12 16 13 15 13 13 16 17 17 17 17 
10 07 07 05 04 02 04 04 02 04 07 05 10 10 12 14 15 15 16 11 11 13 14 14 13 15 18 17 18 16 14 18 13 15 14 15 17 16 17 18 
07 07 05 05 03 04 02 01 00 06 03 09 10 11 12 14 15 15 16 11 13 13 13 14 15 18 16 19 18 15 18 14 15 14 16 17 17 18 16 18 
06 07 06 06 10 09 13 09 10 11 08 10 11 12 13 14 16 17 16 12 13 12 16 17 17 16 20 16 17 17 15 15 15 15 16 16 17 18 17 17 
06 07 08 07 11 11 10 11 12 13 11 10 13 14 14 14 17 16 18 12 14 14 17 17 18 16 17 17 18 19 16 15 16 16 16 16 17 17 17 17 
08 07 07 10 08 12 11 13 12 12 11 14 15 16 16 18 14 17 17 14 13 20 19 20 16 19 14 18 17 17 15 16 16 17 17 18 19 17 15 15 
06 09 10 13 13 11 15 12 14 13 15 15 17 17 17 17 19 17 18 15 18 16 20 20 19 16 20 17 18 18 16 17 19 18 18 17 17 16 16 15 
10 09 12 14 13 15 13 13 14 16 14 16 16 18 17 19 17 19 18 17 15 20 20 20 16 21 17 18 19 19 16 17 17 19 16 17 16 16 14 15 
10 10 12 11 12 13 12 14 14 14 15 15 17 17 17 17 19 18 18 18 17 20 18 19 19 17 16 18 16 16 16 16 16 15 15 15 16 15 14 14 
11 11 12 12 12 12 14 14 14 15 16 16 17 17 17 17 19 19 20 19 17 18 19 18 18 17 17 16 16 16 16 16 15 15 15 15 15 14 14 15 
11 13 11 12 14 13 13 15 15 16 16 20 18 18 18 19 17 20 20 17 20 20 18 15 15 16 19 16 16 16 16 16 15 15 15 15 16 15 14 14 
13 13 14 14 13 14 13 15 15 17 19 17 18 18 18 18 21 20 21 20 18 19 15 16 15 16 15 16 15 16 15 15 16 15 15 16 15 14 14 14 
13 14 12 13 14 13 14 16 17 17 16 18 18 17 18 21 20 21 21 19 20 17 16 16 16 15 16 16 15 15 15 15 15 15 15 15 14 14 13 14 
13 13 12 11 14 13 10 10 11 12 13 13 15 14 14 14 15 16 16 16 16 17 15 14 14 14 14 14 13 13 13 13 14 13 13 13 12 14 15 15 
12 12 13 12 12 10 10 12 12 12 14 15 14 15 14 15 16 16 16 17 16 16 14 14 14 12 15 13 14 13 13 14 13 13 12 15 13 15 14 14 
13 12 11 10 12 09 11 13 15 15 14 13 15 15 15 15 18 17 17 17 16 13 14 14 15 14 11 14 15 14 13 12 12 13 13 12 18 16 16 16 
12 08 09 07 09 12 11 16 16 14 13 14 15 15 16 16 16 17 17 17 14 15 14 14 13 13 14 14 15 13 11 13 14 13 13 15 14 16 16 17 
09 10 08 08 11 10 14 15 17 14 14 14 16 16 16 16 17 17 16 17 15 13 14 14 12 14 14 16 16 12 13 12 13 13 14 13 16 16 16 17 
08 09 11 10 12 13 14 17 18 13 13 18 16 17 17 16 15 16 14 14 13 14 14 15 16 14 15 17 17 12 12 15 15 16 17 15 15 16 16 16 
09 09 11 12 12 13 16 18 19 15 14 17 17 17 18 16 16 14 14 15 14 13 16 15 15 15 16 17 17 13 14 15 17 16 16 15 16 16 16 17 
10 12 09 12 16 16 18 19 19 14 19 15 17 14 14 16 15 14 14 15 14 18 16 16 17 16 20 18 18 13 16 18 16 16 16 16 16 17 17 17 
12 11 15 14 16 18 18 18 20 19 16 19 14 15 14 15 14 16 14 14 15 16 18 17 16 17 18 19 18 17 17 17 17 16 15 16 16 17 17 18 
12 15 13 16 17 18 19 21 22 18 20 15 15 15 15 14 14 14 13 13 15 17 15 16 16 18 18 18 18 16 17 16 15 17 16 16 16 17 17 17 
13 12 13 11 11 12 12 14 13 13 16 15 16 15 15 14 14 13 13 14 15 15 16 17 18 17 21 17 17 18 16 16 16 15 15 15 14 17 16 16 
13 11 12 11 11 11 14 13 13 13 16 15 15 14 14 13 13 14 14 14 14 15 18 18 19 17 18 18 18 19 16 16 15 15 14 15 16 16 15 15 
12 13 09 10 13 13 15 13 12 12 15 18 15 15 14 14 14 14 14 14 15 18 19 21 17 20 15 17 15 15 16 16 15 13 16 15 18 16 16 17 
12 11 13 12 14 13 12 12 11 12 15 14 17 15 14 13 14 14 14 15 17 18 22 21 20 16 20 15 16 16 13 15 13 13 15 16 15 17 16 17 
10 13 11 12 13 12 12 12 10 11 14 15 14 15 14 14 14 14 15 15 17 20 20 22 18 21 15 17 16 17 15 13 14 13 14 14 16 16 16 16 
11 11 10 11 12 11 13 11 11 11 13 15 13 13 13 13 13 13 12 12 17 18 17 16 16 16 16 16 16 16 13 14 15 16 17 15 16 17 17 17 
10 12 11 11 11 13 12 11 12 12 12 14 13 13 13 12 14 12 14 15 18 17 16 16 16 16 16 16 15 15 16 14 17 15 15 15 16 17 17 17 
11 10 12 11 10 12 12 12 11 11 14 11 13 13 13 14 10 14 15 16 17 17 16 15 15 15 17 15 15 15 15 19 16 15 15 17 18 17 17 17 
10 10 10 11 11 11 12 10 11 12 13 14 14 13 13 13 14 16 15 16 17 16 15 15 15 15 15 15 15 15 15 15 15 15 16 17 18 18 18 17 
10 10 11 11 10 12 11 12 11 13 14 12 13 13 13 14 13 15 16 15 16 15 15 14 15 15 15 15 16 15 15 16 16 15 16 18 18 17 18 18 
10 10 11 11 11 11 11 13 12 13 13 13 13 13 13 14 15 15 16 16 15 15 15 15 15 15 15 15 15 15 15 15 16 16 17 18 18 18 17 18 
