72 72 71 70 72 71 70 70 68 68 67 69 67 68 69 70 70 71 69 69 69 67 68 68 68 67 70 66 68 69 70 69 71 69 69 69 71 71 72 73 
71 72 71 70 71 69 70 68 68 68 69 67 69 69 69 70 72 69 68 68 68 68 68 68 69 66 67 69 70 69 68 72 69 71 70 69 70 73 73 73 
72 71 70 70 71 70 68 68 67 66 68 69 69 69 71 71 69 68 67 69 67 70 69 70 66 69 67 71 71 72 70 68 71 71 69 71 74 73 73 73 
71 69 70 68 69 68 69 67 67 67 67 69 69 70 70 69 70 67 59 69 68 68 71 71 66 69 71 71 73 70 71 71 72 72 71 71 73 73 73 74 
71 70 72 70 69 68 68 67 66 71 71 67 68 65 64 69 70 65 59 66 67 67 70 70 70 73 73 75 75 69 70 75 73 73 73 74 71 71 68 68 
71 70 70 70 69 68 68 66 65 69 67 69 58 65 65 67 67 59 65 66 67 70 70 72 73 75 74 76 76 72 70 74 73 74 74 71 72 68 68 68 
70 71 69 68 69 67 67 65 59 71 67 63 58 59 66 68 64 59 64 69 69 67 72 73 73 73 77 77 78 71 76 71 73 70 70 71 67 67 68 68 
71 68 69 67 66 59 66 66 65 59 63 58 66 65 66 59 67 64 65 68 69 71 71 73 76 77 76 79 79 76 71 76 71 71 69 69 68 69 68 68 
68 70 66 66 66 66 65 64 63 57 63 64 66 64 64 67 64 59 64 70 70 71 75 74 76 75 78 78 80 74 77 71 71 68 69 68 67 68 67 67 
67 67 66 69 69 67 71 59 66 66 63 57 57 55 55 62 57 56 54 70 68 70 59 59 65 66 62 67 58 58 72 70 71 70 70 69 71 69 71 72 
66 67 67 70 70 68 67 66 67 67 62 58 55 60 65 60 61 65 59 70 67 67 65 59 63 66 67 58 64 58 71 71 70 70 70 70 69 72 71 71 
68 66 72 71 66 69 63 66 65 65 58 55 65 63 63 58 61 54 56 67 69 63 57 55 68 63 59 64 59 59 70 71 71 71 68 70 73 72 71 71 
67 70 68 71 68 59 69 66 66 59 60 60 58 57 64 60 63 57 55 68 58 66 57 56 62 57 61 59 58 66 70 70 70 71 71 71 72 72 72 71 
67 67 71 71 66 70 59 65 65 66 61 58 63 61 58 56 55 62 56 58 67 56 56 56 55 60 58 65 57 64 69 71 72 71 71 72 72 71 72 73 
69 68 70 68 66 66 58 58 61 54 65 57 55 56 63 60 54 61 65 58 57 62 62 56 62 62 66 66 68 69 70 71 71 71 71 71 71 71 71 71 
69 68 68 66 65 58 59 60 61 56 61 55 57 56 62 60 61 59 54 63 56 56 56 57 57 66 65 69 69 69 70 71 71 71 71 70 72 71 72 73 
67 69 66 58 65 58 60 55 55 55 57 59 56 59 65 55 58 60 54 63 55 57 64 59 59 67 70 70 68 68 71 72 71 71 71 71 70 72 73 74 
68 63 59 55 55 61 61 60 54 62 55 63 59 54 65 65 61 62 55 55 63 62 59 65 66 68 70 68 69 69 71 71 71 71 71 71 72 75 74 74 
63 66 61 61 55 55 60 62 56 61 58 61 54 54 54 55 54 54 59 57 55 58 65 59 67 70 69 69 70 71 71 71 71 71 72 72 73 74 74 74 
56 62 63 57 62 63 62 65 61 60 64 54 57 54 55 55 63 56 55 55 63 64 59 59 65 59 64 59 58 64 64 66 64 64 65 67 59 71 68 68 
62 62 56 58 62 62 65 54 61 54 65 63 55 60 62 54 63 55 62 63 58 59 65 64 64 59 59 58 58 59 65 65 65 65 59 67 70 68 68 68 
62 63 58 63 65 64 55 54 58 63 65 55 55 62 56 58 65 61 59 59 58 66 58 57 66 64 65 64 65 64 66 64 65 59 70 67 71 68 69 70 
58 63 63 56 63 54 60 63 63 54 55 62 62 57 57 61 57 65 60 54 63 58 63 63 58 64 58 65 59 66 66 67 66 66 67 68 67 71 69 69 
56 57 62 62 59 54 58 65 62 62 61 62 56 62 60 63 65 61 54 60 64 63 57 57 65 57 59 59 66 65 67 59 65 65 67 66 69 69 67 67 
62 61 62 61 65 58 65 55 53 61 55 55 64 63 57 60 64 56 58 59 57 66 65 65 59 64 58 65 59 66 66 65 67 66 66 68 70 68 68 68 
56 56 60 64 65 57 57 53 53 58 58 64 57 64 64 61 62 65 66 66 59 65 59 65 65 65 59 65 64 65 66 66 66 66 67 69 69 68 70 71 
60 55 61 58 63 64 51 52 50 55 61 63 65 56 57 57 65 67 68 69 66 66 65 64 58 59 67 65 58 67 65 67 67 68 69 70 67 70 70 71 
55 59 63 61 53 52 54 50 50 60 63 55 56 56 65 66 68 69 69 69 66 66 64 64 64 65 58 65 58 65 66 66 69 68 69 69 72 71 71 71 
65 64 61 53 53 55 50 51 51 61 53 60 63 64 58 67 68 68 71 71 67 58 58 57 64 58 64 64 58 66 59 67 68 68 69 72 70 71 71 72 
63 65 57 59 67 64 54 59 60 55 58 60 61 63 58 66 69 70 69 69 59 65 65 63 62 63 63 59 59 65 67 67 69 69 70 70 72 72 72 72 
63 60 56 54 63 57 64 55 60 54 54 60 64 66 66 67 70 69 70 70 64 66 56 58 62 57 64 65 66 66 68 68 70 71 71 72 72 72 73 73 
56 65 61 54 62 58 56 62 63 58 61 58 67 69 68 71 69 69 67 67 59 61 63 58 58 58 66 67 67 67 68 69 71 72 71 73 72 73 72 72 
59 63 62 62 58 55 65 56 58 66 58 67 70 70 71 68 71 68 68 67 64 58 65 58 64 64 65 66 67 69 69 71 74 73 73 72 73 72 72 72 
57 62 56 63 54 63 57 64 65 68 66 68 69 72 68 71 68 68 66 67 58 63 59 65 63 59 66 68 68 70 70 72 72 74 72 73 72 72 71 73 
56 63 66 64 61 63 60 66 58 57 66 59 66 59 65 67 68 59 59 66 58 67 66 67 68 66 66 68 66 66 70 72 72 72 72 72 72 71 70 70 
61 54 57 59 59 62 65 63 63 64 66 66 65 59 65 66 67 66 67 67 58 66 68 68 68 65 68 66 68 69 72 72 72 72 72 70 72 70 71 72 
58 67 62 61 69 56 59 64 64 58 66 66 59 59 66 68 63 66 66 66 67 67 67 66 66 68 64 68 69 70 72 73 72 71 71 72 68 71 72 73 
68 62 69 63 55 57 61 57 63 59 64 59 66 59 66 59 68 67 67 66 67 69 67 67 66 66 68 69 69 71 72 72 71 71 71 70 72 73 72 73 
59 71 56 55 63 55 57 65 62 57 65 59 66 66 65 68 66 66 66 67 69 67 67 67 67 68 67 70 70 70 72 71 71 72 71 72 71 72 71 72 
63 59 56 55 56 62 63 57 64 58 65 65 65 66 66 67 67 67 66 67 68 67 68 66 67 68 69 70 71 71 71 71 71 71 71 72 72 72 73 73 
