58 63 58 57 63 63 63 58 64 64 65 63 66 66 66 64 67 62 64 59 59 68 65 64 58 67 56 70 58 63 61 63 59 55 62 63 58 59 57 57 
58 62 63 58 63 56 57 58 58 63 66 59 66 59 66 65 63 65 67 66 66 66 64 58 57 59 69 63 57 57 61 54 62 62 63 57 59 57 58 65 
63 57 56 62 63 57 66 59 59 66 58 68 66 67 57 65 58 68 68 59 68 62 57 61 70 59 58 62 62 60 62 56 57 64 58 65 64 58 57 63 
56 62 63 56 64 58 58 59 66 67 65 65 67 67 57 59 67 69 72 57 58 66 61 61 67 66 63 56 59 61 61 57 64 59 58 59 59 57 63 57 
64 57 57 63 57 64 59 67 67 62 57 67 67 68 68 69 68 71 71 71 68 68 56 61 55 59 56 60 60 58 58 58 64 56 62 66 68 59 67 68 
57 57 63 58 64 65 66 68 68 58 58 67 68 69 70 69 71 71 72 69 65 58 55 60 60 65 54 60 58 61 63 56 62 56 62 68 65 68 69 69 
57 56 63 58 65 66 69 69 69 65 68 67 69 69 69 69 71 72 74 65 65 55 60 64 57 61 62 64 55 59 58 64 57 66 68 67 68 70 70 71 
56 58 58 67 67 69 69 70 70 69 68 71 69 70 70 71 71 75 74 64 54 55 64 64 63 64 59 56 55 58 58 65 67 66 69 69 71 71 72 71 
58 57 66 67 68 68 69 70 70 69 71 69 70 71 71 70 73 74 75 54 62 64 58 56 58 60 56 55 55 61 63 59 66 66 67 70 71 70 72 73 
64 64 59 65 64 65 70 70 71 71 69 71 70 69 69 71 68 73 72 65 56 54 68 57 56 56 56 64 65 66 62 59 56 56 56 59 54 68 64 57 
64 64 58 66 67 67 69 71 71 72 69 71 69 70 68 69 72 72 74 59 61 67 62 57 62 57 62 66 66 66 63 57 56 62 61 63 67 57 62 62 
64 65 65 67 66 71 72 72 70 70 71 67 69 69 73 70 70 74 77 66 57 58 63 63 62 56 69 68 69 69 65 62 62 59 68 63 59 62 56 62 
59 66 69 70 72 71 73 71 71 70 68 71 70 69 69 72 73 78 78 57 57 61 62 61 57 66 65 68 69 71 62 58 65 60 56 56 59 62 60 57 
67 68 70 72 72 74 71 71 70 71 71 68 69 69 71 71 76 78 80 61 55 61 58 56 65 58 69 69 70 72 59 54 60 65 60 59 61 57 55 59 
68 68 66 69 71 71 72 72 73 73 70 72 72 74 75 75 78 80 80 56 57 76 70 73 74 68 57 69 59 64 55 62 60 60 60 54 63 61 61 62 
67 69 68 71 71 72 71 73 73 74 71 72 75 76 77 75 80 81 84 69 68 71 74 73 73 66 68 58 63 57 61 55 60 54 60 55 61 62 55 55 
69 67 73 73 70 72 76 75 75 76 73 73 77 78 79 80 78 84 86 58 77 74 72 67 66 59 68 57 56 62 55 61 60 60 54 57 64 55 59 65 
68 70 69 72 74 76 74 77 76 75 76 77 78 79 80 81 85 87 87 79 72 79 69 69 57 64 54 56 54 56 65 61 54 54 60 61 57 61 60 58 
68 68 73 73 73 74 76 75 76 76 76 77 79 81 82 84 84 87 88 74 82 70 66 59 59 60 62 56 55 65 61 54 60 54 55 57 55 59 58 65 
70 70 68 68 70 68 71 66 67 67 66 68 65 58 64 66 55 67 57 62 72 71 68 66 66 66 66 66 65 65 64 57 56 60 54 59 57 57 56 56 
69 70 69 68 70 69 67 67 67 67 67 66 58 58 56 58 67 62 56 62 70 70 66 67 66 59 66 65 58 64 58 56 60 58 64 65 63 56 62 63 
70 68 68 69 66 69 68 67 66 66 68 65 63 55 68 57 57 55 55 56 70 59 67 67 66 66 58 58 62 57 62 63 58 63 65 62 57 63 57 63 
67 68 68 71 69 66 69 67 67 67 58 65 56 61 61 56 59 55 54 63 67 68 68 67 65 63 64 56 56 56 60 64 58 56 56 61 55 56 57 59 
68 67 70 71 68 70 67 66 67 58 66 62 55 54 60 64 60 56 54 59 68 66 67 66 63 58 56 57 62 58 59 57 62 60 60 55 57 58 59 59 
68 67 69 68 67 67 59 66 59 57 56 57 60 65 59 60 56 54 59 59 66 66 58 64 64 62 57 62 60 64 57 59 63 64 58 62 57 59 64 58 
68 69 68 67 67 59 66 65 58 63 54 61 65 60 60 54 55 59 54 60 66 64 64 56 56 61 56 54 60 58 58 63 58 64 64 57 58 58 64 65 
67 69 68 66 67 59 59 64 58 61 62 65 54 60 54 56 58 65 64 64 59 67 57 56 62 56 55 61 60 62 64 59 64 63 57 58 59 65 65 65 
69 66 68 66 58 59 57 66 64 56 65 62 61 60 65 65 56 60 59 57 63 57 58 62 54 61 55 54 54 64 64 65 64 64 57 58 58 58 58 60 
59 68 59 64 58 57 64 64 59 61 62 65 65 65 65 56 58 64 64 58 57 63 55 61 54 61 54 60 60 65 59 64 57 63 64 64 64 65 65 59 
66 64 58 57 55 60 58 59 57 57 54 59 55 65 59 64 63 58 59 65 56 55 54 58 64 58 63 57 63 63 64 64 63 56 62 57 52 57 61 55 
59 58 62 55 59 65 65 57 57 57 61 54 65 58 58 64 63 65 57 57 59 55 64 58 57 56 63 57 57 57 63 64 56 61 60 57 56 55 54 60 
63 57 63 54 54 63 58 57 56 62 59 63 59 57 58 63 62 65 65 59 61 56 57 57 64 63 57 57 63 63 64 56 54 53 64 53 65 62 57 58 
57 60 65 57 63 62 55 61 56 58 65 57 58 63 58 59 63 58 64 54 56 64 58 63 62 57 56 57 63 64 56 62 61 53 53 61 53 65 57 64 
54 60 63 62 60 61 62 58 58 57 63 58 63 55 58 56 65 65 54 54 64 56 64 57 56 56 57 57 62 57 62 53 52 52 54 52 57 57 62 62 
58 57 63 58 55 55 57 57 63 58 58 61 65 59 65 58 57 59 64 58 56 65 57 63 63 62 62 57 57 57 61 56 60 60 55 61 63 58 64 58 
57 58 56 64 58 56 63 58 58 58 58 65 65 65 60 64 59 58 64 58 57 57 57 63 63 56 63 63 55 55 61 55 55 56 62 57 57 64 58 58 
62 62 65 63 57 57 57 58 57 63 55 59 65 63 57 64 60 64 58 58 65 64 63 55 61 56 59 62 60 60 56 52 61 55 62 57 59 64 57 57 
63 64 63 58 56 63 58 62 63 64 65 55 57 64 57 57 57 64 63 58 57 59 56 62 54 61 61 54 60 61 54 57 56 56 56 64 64 56 57 58 
64 57 63 56 63 58 57 64 64 65 56 64 64 62 64 63 63 58 63 57 59 56 55 56 55 61 61 61 61 55 63 61 56 57 63 64 57 64 58 65 
63 57 63 56 63 57 57 59 58 65 59 58 65 63 63 63 57 57 57 63 57 62 56 54 54 60 60 55 61 55 56 56 57 62 57 63 63 59 58 65 
