69 68 68 67 68 67 59 66 58 58 63 64 62 58 59 59 69 66 67 67 66 70 68 71 72 74 75 78 75 74 73 71 70 71 72 70 75 68 71 72 
68 67 68 66 66 66 66 58 58 58 64 62 59 66 67 66 67 67 68 68 68 68 72 73 73 76 78 74 74 72 72 70 72 72 73 71 69 72 72 73 
68 68 66 59 67 59 59 58 63 56 63 57 67 68 65 69 59 68 68 66 70 73 74 74 76 77 77 73 71 72 70 71 73 74 68 73 72 73 71 70 
67 59 66 64 66 65 58 63 57 62 58 59 69 71 65 67 70 68 69 69 71 73 74 76 76 76 75 70 68 71 72 71 75 76 70 71 73 70 72 73 
68 66 67 66 57 57 63 57 63 58 66 61 70 68 68 72 73 72 74 74 75 69 74 71 70 75 76 70 71 69 71 68 75 73 72 77 75 73 73 74 
67 59 59 64 58 56 57 63 61 56 66 67 68 68 68 74 71 75 74 71 71 73 70 69 69 73 71 71 69 68 71 73 72 72 72 74 74 74 74 74 
59 66 65 63 58 57 66 62 61 69 58 72 70 72 73 71 77 75 76 76 70 71 69 70 71 73 73 69 68 74 70 74 72 73 74 73 73 74 76 77 
66 57 64 56 55 56 62 57 55 58 69 59 72 71 74 75 74 77 77 69 70 67 70 69 72 71 71 70 69 70 71 69 73 72 75 74 74 77 77 77 
63 58 56 61 61 62 56 54 54 66 63 71 72 73 73 73 77 76 78 68 66 69 71 70 69 72 70 67 67 69 68 72 74 72 73 73 76 76 77 78 
56 56 63 66 64 59 69 68 69 70 69 71 73 75 76 77 82 80 81 69 72 69 78 76 76 74 78 74 76 77 69 72 69 70 70 72 69 74 69 68 
62 64 57 67 66 68 68 70 71 72 72 72 76 78 79 78 81 82 84 69 74 75 76 76 77 76 74 77 76 76 70 69 70 70 69 70 74 68 68 69 
63 64 69 69 66 70 70 72 72 72 72 76 79 80 78 83 79 84 84 75 72 79 77 77 73 76 79 77 76 76 71 72 70 69 74 71 69 68 67 67 
65 68 68 70 71 71 73 72 73 73 76 77 79 81 83 82 86 84 85 73 75 72 76 76 78 76 78 76 77 76 71 72 71 70 69 69 67 67 66 67 
67 67 70 70 72 73 72 72 73 74 76 79 82 83 83 86 83 85 86 75 71 76 79 77 76 78 77 76 77 79 72 70 68 68 68 67 66 68 59 64 
68 69 67 68 72 72 74 74 74 75 78 78 82 82 83 84 85 86 87 74 74 84 78 79 80 76 71 75 70 69 70 67 67 67 67 66 69 58 64 59 
67 69 69 69 70 74 74 75 77 78 80 80 83 83 83 84 86 87 89 79 77 80 80 79 79 73 75 69 68 68 69 67 67 59 64 65 66 65 59 66 
70 68 69 71 71 74 73 78 79 80 80 86 84 85 86 86 86 89 90 75 85 79 78 73 71 72 71 68 68 68 66 70 65 58 64 68 56 65 57 63 
67 70 70 73 75 75 78 80 81 81 84 83 87 86 86 87 89 89 91 86 78 84 74 74 69 69 66 69 66 67 59 64 64 58 64 64 67 57 58 58 
69 69 72 75 75 77 79 80 80 83 82 86 85 86 87 88 89 92 91 80 87 75 72 71 70 66 67 67 66 58 64 59 58 57 58 68 57 64 58 58 
71 71 69 68 72 70 68 67 67 67 66 69 67 68 69 71 69 72 68 67 77 76 74 74 75 74 78 74 76 77 78 73 78 75 74 71 73 67 69 70 
70 69 70 68 70 69 67 67 66 68 68 67 69 69 69 69 73 67 68 69 74 75 75 75 76 77 74 77 77 75 75 77 74 73 73 70 68 70 70 70 
71 69 68 68 69 67 68 67 67 66 69 70 69 69 73 71 66 67 66 66 75 73 76 77 73 77 78 77 75 79 74 77 73 73 69 70 67 70 70 71 
68 66 66 65 66 67 66 67 67 70 69 70 70 69 69 67 67 66 59 66 75 76 78 78 78 77 78 75 76 74 73 71 74 72 70 70 72 70 72 72 
66 66 59 66 66 65 67 67 68 69 70 69 68 68 66 67 59 67 63 63 75 76 78 80 77 79 76 76 76 73 70 73 73 73 70 72 70 71 71 74 
59 59 69 70 66 66 65 67 66 69 68 67 67 67 67 65 68 59 66 66 76 73 75 74 74 77 77 78 79 72 71 78 73 73 74 72 67 71 67 66 
67 67 67 67 70 66 67 66 66 68 67 66 67 59 59 67 59 66 65 59 75 75 74 75 75 76 77 79 79 75 73 74 74 73 73 70 71 66 66 66 
65 69 71 68 69 66 68 66 65 67 66 70 66 65 59 67 69 59 57 63 73 73 75 76 77 77 80 80 81 71 78 73 72 68 67 68 67 66 66 67 
71 68 69 67 58 65 58 64 64 66 67 59 66 59 65 66 67 64 58 56 73 73 76 76 79 79 80 81 82 78 72 77 69 69 59 59 58 67 59 67 
69 70 66 64 59 58 59 66 65 65 65 66 59 59 65 67 59 63 56 63 72 75 77 79 78 79 81 82 83 73 79 70 68 67 66 58 65 67 59 58 
67 66 66 59 64 58 64 59 65 59 66 65 59 62 55 61 65 54 65 65 72 72 69 68 68 69 67 69 67 67 71 70 67 67 67 66 67 66 66 66 
66 64 59 59 58 65 59 59 57 57 59 66 61 62 54 65 54 59 55 62 70 70 68 68 67 69 69 67 66 66 69 69 67 67 67 67 66 66 59 59 
65 65 59 58 65 58 67 58 62 62 65 54 55 60 61 59 58 55 57 64 71 68 68 66 70 68 68 66 66 66 69 65 67 67 66 67 69 66 65 65 
65 58 59 59 65 57 63 56 62 63 54 55 60 65 58 65 55 58 64 65 68 69 67 67 67 66 65 67 65 66 66 67 66 67 67 67 66 59 65 65 
63 59 64 58 63 63 57 57 63 56 56 65 55 59 64 54 56 64 58 59 70 67 67 66 59 59 65 66 65 58 67 66 68 68 66 66 66 59 65 59 
64 63 57 63 56 62 57 56 63 57 54 65 61 62 57 55 55 64 63 63 67 66 59 64 58 64 66 58 64 64 66 65 58 64 58 59 65 65 59 59 
63 56 56 55 62 63 56 63 62 56 55 56 57 58 64 61 57 57 63 63 59 65 64 64 64 57 59 64 64 58 63 65 64 58 58 65 59 59 65 59 
63 56 58 56 61 57 64 63 61 61 65 60 57 55 61 56 66 63 62 62 65 58 64 57 57 59 64 58 63 57 59 56 57 63 63 59 66 65 58 58 
62 62 55 54 61 61 62 61 61 62 61 66 61 56 55 64 61 61 55 63 56 58 64 63 63 57 65 57 63 57 63 58 57 63 58 65 64 58 64 59 
54 55 55 55 61 56 55 62 55 62 67 61 56 56 63 55 62 63 62 56 64 57 57 64 63 65 57 57 62 63 58 56 64 63 58 58 64 65 58 65 
55 54 54 61 55 55 61 56 56 62 64 62 58 55 62 55 55 56 62 62 57 63 57 57 63 64 57 58 63 63 57 63 58 64 64 64 64 65 59 66 
