40 39 40 39 39 39 36 39 38 38 38 38 39 39 39 39 40 40 41 42 42 45 43 46 47 49 52 53 52 52 53 50 53 50 50 48 48 46 48 49 
40 38 39 38 37 38 38 38 37 38 39 38 39 39 39 40 39 42 42 43 44 43 47 49 49 50 53 52 54 51 52 53 50 49 49 48 46 49 49 50 
39 39 38 37 40 36 40 38 38 38 38 42 40 40 39 40 42 43 44 42 45 45 50 51 51 54 50 53 53 54 51 50 48 48 47 46 49 51 52 53 
38 37 38 36 40 38 36 39 38 40 40 39 41 41 40 42 42 44 45 43 47 49 52 61 50 53 56 53 53 52 50 49 48 46 48 49 48 53 61 62 
40 38 39 37 33 34 36 38 38 38 39 38 41 42 42 43 44 46 47 48 50 45 52 50 50 56 64 55 56 48 47 61 49 52 53 49 47 53 51 51 
39 37 36 37 37 34 37 38 38 38 40 40 42 43 43 45 45 48 49 46 48 51 50 51 52 63 61 63 64 51 51 50 53 53 53 49 52 51 52 52 
36 37 35 35 39 38 38 38 39 40 39 45 44 45 46 45 46 49 50 53 48 49 51 53 54 63 62 59 65 47 61 52 53 51 50 50 50 52 53 53 
37 37 38 38 37 39 39 40 39 40 42 42 45 45 47 48 49 50 51 47 49 47 51 52 64 64 65 65 60 62 52 63 52 52 49 50 50 52 52 61 
37 38 37 37 39 39 38 39 39 40 41 45 45 45 47 48 49 52 51 48 46 51 56 56 56 59 65 60 60 54 64 52 50 50 51 50 51 60 52 53 
37 37 38 41 39 39 43 42 44 45 43 45 46 46 46 48 46 51 50 49 51 50 54 51 50 50 49 51 50 50 51 53 49 50 51 51 50 52 49 48 
37 39 38 40 41 41 42 45 46 46 43 46 46 46 46 48 50 50 52 49 50 60 50 51 49 49 51 50 51 52 51 50 51 50 50 51 52 48 46 46 
38 38 44 43 40 44 44 46 46 46 46 44 46 46 50 48 50 53 61 60 52 51 51 51 51 50 49 51 53 54 51 51 50 49 52 50 51 46 44 43 
40 41 42 45 45 45 47 47 47 46 45 47 46 46 48 50 50 53 55 51 50 51 53 51 49 50 51 54 60 55 51 51 50 50 50 48 46 44 43 43 
41 41 44 44 45 47 46 46 48 48 47 45 46 45 50 49 53 63 64 50 51 51 51 49 50 50 52 60 55 55 51 50 49 49 46 46 45 44 41 41 
42 43 42 42 46 46 47 47 48 48 46 49 51 53 54 53 56 65 60 50 50 65 53 60 54 52 49 52 48 47 49 46 46 45 45 44 46 41 41 41 
42 42 44 43 43 46 47 48 49 50 48 50 54 61 56 55 58 61 63 54 60 55 54 55 61 51 52 47 47 47 48 46 45 42 42 42 43 41 41 41 
44 43 42 44 45 47 46 49 50 51 51 60 62 64 59 59 65 57 58 50 65 53 53 50 49 50 47 46 46 46 45 47 43 42 42 44 38 40 40 40 
42 43 44 45 48 48 49 49 51 53 54 62 64 59 54 62 57 63 65 54 53 54 51 51 47 47 46 46 45 46 45 41 43 41 41 39 43 41 40 39 
44 43 45 47 48 49 49 52 53 54 55 63 58 61 55 63 63 66 67 60 62 51 49 49 48 46 45 46 45 43 41 42 41 41 40 43 39 39 39 39 
44 44 43 44 46 44 44 43 43 44 42 46 41 42 42 45 41 48 43 42 53 52 51 49 49 48 46 48 48 48 49 45 49 47 47 45 48 42 43 44 
43 45 44 44 45 44 42 44 42 45 42 42 42 43 41 43 47 42 42 42 53 51 49 47 47 48 47 48 47 46 46 48 47 47 47 45 43 44 45 45 
45 43 45 44 43 43 46 42 41 41 45 40 42 41 48 44 43 41 39 39 51 52 48 46 48 45 51 48 48 50 46 47 47 47 43 46 42 45 45 45 
43 43 42 42 43 42 42 41 41 44 41 46 43 43 43 40 39 38 37 40 49 48 48 46 46 48 45 47 48 45 45 44 46 46 45 44 47 45 46 45 
42 42 42 43 41 42 42 41 42 41 46 42 41 41 40 39 38 41 37 36 49 47 45 45 47 44 48 49 50 45 44 46 48 47 46 47 45 45 46 48 
42 41 45 41 41 41 39 39 37 42 41 38 37 36 36 38 42 37 38 39 47 47 47 48 48 48 49 50 51 45 45 50 46 46 47 45 42 44 41 41 
43 40 43 41 40 39 40 36 36 40 37 38 36 36 36 38 39 39 40 40 48 47 48 48 48 47 50 51 52 47 47 47 47 47 47 43 45 41 41 42 
41 45 38 38 42 39 38 36 35 40 37 35 36 37 38 41 37 39 37 37 46 49 49 49 49 50 50 52 52 45 50 47 46 43 43 43 41 41 42 42 
44 39 42 38 36 36 36 36 35 35 35 35 37 37 39 39 42 38 39 37 47 47 48 49 50 52 52 51 53 51 45 50 44 44 42 42 40 43 41 42 
40 44 36 36 36 36 35 35 34 35 35 36 38 37 38 43 38 38 38 39 47 49 49 50 51 52 52 60 54 48 51 44 43 42 42 40 41 42 41 40 
39 38 38 37 38 37 37 35 35 35 36 35 38 36 36 36 35 37 37 37 46 46 46 46 46 46 46 45 43 43 45 44 42 42 42 41 42 41 41 41 
38 36 38 37 37 35 36 35 36 36 35 37 36 36 35 36 36 37 37 38 48 45 46 45 46 44 46 43 43 43 45 43 42 42 42 41 41 41 40 40 
38 37 36 36 36 36 34 36 36 36 36 40 36 36 37 36 38 38 39 40 45 50 46 46 46 46 44 43 40 40 43 43 42 42 41 41 42 40 39 39 
37 35 36 36 36 36 36 35 36 37 37 35 36 35 36 38 37 39 39 41 46 46 48 47 46 43 43 40 40 40 42 42 42 42 41 40 40 40 39 39 
35 36 36 37 36 36 35 36 36 37 35 36 36 35 37 36 38 40 41 41 46 47 45 45 43 44 41 41 41 40 42 42 42 43 39 40 39 39 39 39 
35 35 36 34 36 36 36 38 38 38 36 41 39 39 40 39 38 41 40 40 45 44 42 41 41 41 41 39 39 39 41 40 38 38 38 39 39 39 39 39 
35 33 36 35 35 38 37 38 38 38 38 39 40 40 41 39 40 40 39 39 45 43 41 40 40 40 40 39 39 39 39 39 38 38 38 40 39 39 39 39 
35 36 32 34 38 37 41 38 37 37 41 41 40 38 37 39 42 39 38 38 43 42 40 39 39 40 39 38 37 37 39 37 37 37 37 39 39 39 38 38 
35 33 37 36 37 39 37 37 37 38 39 42 37 38 38 39 37 37 37 39 40 40 39 39 39 39 39 38 38 37 37 38 37 37 38 38 39 38 39 39 
33 37 35 37 38 37 38 38 38 38 43 38 39 37 39 37 38 39 38 38 40 39 39 39 38 39 38 38 37 37 38 37 38 36 38 39 39 39 39 40 
34 36 36 37 38 37 37 38 38 39 40 38 40 38 38 37 37 38 39 39 39 39 39 38 38 38 38 38 37 37 37 37 38 38 38 39 39 40 39 40 
