38 32 31 36 40 33 30 29 27 27 25 30 24 24 24 28 22 38 26 24 24 23 24 23 23 22 25 21 22 22 20 23 20 22 23 23 25 25 24 24 
31 30 38 31 38 37 36 27 27 28 26 25 24 25 23 26 37 24 24 23 23 23 23 23 24 23 22 22 21 22 22 20 23 23 24 23 25 24 24 24 
39 32 30 36 38 29 29 27 26 24 29 24 24 22 32 26 25 23 23 24 23 25 24 25 21 24 22 21 19 19 21 25 24 24 24 26 25 24 23 23 
31 31 36 28 36 29 27 26 26 24 25 27 22 22 28 26 25 23 20 24 24 23 25 25 21 22 23 18 18 22 22 23 24 26 24 24 25 23 21 21 
37 29 33 31 26 26 24 25 22 34 30 25 22 21 21 20 26 22 24 22 23 23 24 21 21 24 21 18 16 24 25 18 23 19 18 26 28 23 25 26 
32 31 29 29 29 25 25 22 20 29 27 23 21 20 20 23 22 25 25 22 22 25 21 21 21 22 19 16 15 21 21 23 18 19 20 26 24 26 26 27 
28 38 36 26 28 24 25 21 20 27 21 24 21 22 23 26 25 25 23 24 24 20 19 17 17 19 18 15 13 26 19 18 20 21 22 26 23 26 26 26 
32 27 29 24 22 22 21 22 19 20 23 19 23 22 24 24 28 24 24 23 19 20 17 16 17 16 14 14 13 17 20 16 20 20 25 24 27 26 27 27 
27 36 24 22 22 21 20 19 19 20 18 22 22 23 23 29 24 23 24 19 21 17 18 17 15 14 14 14 13 18 15 19 23 22 23 27 26 27 28 29 
26 26 24 23 27 25 25 23 24 25 22 21 22 19 19 20 17 21 20 18 17 18 18 17 17 17 16 18 18 19 20 21 24 23 23 24 23 27 28 28 
25 25 25 24 26 26 23 25 23 23 19 23 19 20 18 20 20 20 20 18 18 17 17 16 16 16 17 19 19 19 21 23 23 24 23 25 26 28 29 30 
26 24 22 23 24 23 28 24 24 24 22 17 18 17 21 18 23 21 22 17 17 20 17 16 18 16 20 19 20 21 23 24 24 24 26 25 28 31 33 34 
23 22 22 22 24 24 23 24 24 24 19 19 17 17 19 20 18 22 21 18 16 17 18 16 17 19 17 20 20 22 22 24 25 24 25 28 28 39 33 36 
21 22 22 24 23 23 25 23 23 24 20 17 18 16 19 17 21 22 21 16 17 17 15 16 17 16 20 21 21 22 24 24 24 23 27 27 37 34 30 36 
22 22 25 23 23 23 22 23 21 21 18 23 21 22 22 20 19 21 20 16 16 16 16 17 18 19 21 24 25 26 24 28 28 30 37 37 38 41 30 37 
23 22 24 22 23 21 23 21 21 22 20 21 22 22 22 20 21 20 19 16 16 17 18 19 20 22 22 26 26 27 27 28 37 39 40 38 41 31 32 38 
22 25 21 21 25 22 22 21 21 21 23 23 22 20 20 20 22 19 18 17 17 15 19 22 23 23 27 27 28 28 36 28 39 40 35 34 41 38 40 41 
25 22 25 21 21 22 21 21 21 22 21 25 21 21 19 21 19 19 18 16 19 20 23 23 24 25 26 27 28 36 36 35 35 30 41 31 32 35 41 41 
23 26 21 21 22 21 21 22 21 21 26 21 20 20 20 19 19 18 17 19 19 21 22 25 24 26 27 29 29 31 34 34 41 41 37 31 39 34 41 42 
22 21 25 25 21 24 26 32 36 36 29 27 27 26 26 24 27 24 27 29 21 21 22 22 22 22 25 24 25 26 26 30 29 38 33 41 31 41 32 38 
23 24 23 25 23 25 37 36 36 28 29 28 26 27 26 27 23 29 28 28 21 23 22 24 23 23 25 26 27 28 29 29 33 40 35 30 40 38 37 37 
21 25 26 26 28 29 32 29 27 29 27 26 27 28 23 26 31 30 36 30 22 20 24 25 23 25 23 27 26 27 36 33 35 41 38 33 35 37 35 40 
26 26 29 30 36 29 28 26 26 26 27 26 28 28 28 29 36 36 37 36 21 23 25 25 25 26 27 25 27 38 34 41 35 37 34 37 31 41 34 40 
26 29 28 27 29 29 27 28 25 27 26 27 28 28 29 29 37 29 32 39 23 23 26 26 27 27 26 28 28 34 41 30 36 31 31 32 35 35 39 39 
27 27 24 25 28 27 30 26 27 27 27 28 29 29 30 30 29 38 38 38 23 26 27 27 28 27 26 27 27 35 35 38 34 33 33 35 31 40 41 30 
25 25 26 24 25 27 27 28 28 27 28 28 30 36 30 30 37 38 33 34 24 26 28 27 27 26 28 27 28 33 40 34 33 33 39 37 34 30 35 35 
27 24 27 27 24 29 26 28 28 28 28 37 31 31 31 36 32 34 30 37 27 36 28 26 26 27 25 27 28 35 38 40 33 40 34 30 38 35 40 34 
24 25 23 25 28 28 30 36 29 29 36 30 30 37 38 40 38 31 36 37 28 29 27 27 26 26 27 28 28 38 32 37 40 33 35 41 30 41 35 39 
25 22 26 28 27 36 28 28 29 36 29 37 31 39 39 37 35 30 37 31 29 27 26 25 26 27 27 29 30 31 31 39 40 34 34 36 35 40 34 40 
24 27 25 28 37 41 30 33 34 34 29 32 29 36 37 33 33 41 38 31 28 29 29 30 37 37 33 32 38 32 39 32 34 40 34 34 41 40 35 36 
24 28 31 38 30 34 33 34 34 41 36 29 31 32 38 32 36 37 38 39 29 29 31 31 38 30 38 38 33 33 32 34 40 40 40 39 40 36 36 30 
30 28 31 33 33 34 36 36 30 37 31 32 33 38 35 35 30 37 29 29 29 29 37 33 37 39 32 33 31 37 39 39 40 41 40 35 35 36 36 37 
28 31 36 33 41 30 37 32 32 30 32 39 32 39 34 31 32 29 28 29 36 32 34 40 39 37 33 30 37 32 39 40 36 30 41 34 37 31 31 37 
37 29 33 30 36 36 31 36 32 32 33 32 39 33 31 33 28 30 29 27 31 38 33 39 37 40 31 38 37 39 40 41 36 36 41 31 36 30 30 31 
31 32 40 30 36 36 32 41 38 37 37 28 36 29 29 29 32 28 29 29 37 31 36 36 30 31 32 39 39 39 40 31 41 35 30 35 41 36 35 41 
41 40 38 30 35 39 35 37 30 36 36 29 29 27 27 29 29 29 29 29 36 37 30 31 37 31 32 33 39 33 40 36 30 30 30 41 30 35 30 36 
39 41 32 32 39 39 39 36 29 29 27 39 29 29 29 31 29 29 28 28 31 27 36 30 31 38 41 34 34 34 31 36 30 40 40 41 40 35 36 31 
35 32 40 38 36 29 28 28 28 30 30 26 29 28 30 36 37 29 29 28 28 31 30 31 38 33 33 35 40 40 35 31 35 35 40 34 41 37 30 31 
35 42 30 30 30 28 29 30 29 28 25 29 29 29 29 32 29 28 29 29 37 30 32 32 32 39 34 34 40 40 38 35 40 40 40 35 41 30 36 36 
39 35 30 29 28 28 28 28 29 28 27 28 28 30 36 30 29 30 28 29 31 31 32 32 33 39 34 34 40 41 36 41 41 40 40 41 36 36 37 37 
