40 39 34 41 33 39 41 40 32 38 35 31 31 30 30 37 27 32 27 26 27 23 27 23 22 20 19 18 19 20 20 27 24 27 29 34 29 35 40 32 
34 40 39 34 34 32 35 32 37 37 40 33 36 36 28 29 32 26 26 24 25 27 22 22 20 21 18 20 21 23 25 23 29 29 29 39 33 32 37 37 
39 40 42 41 34 41 32 30 33 39 41 30 29 27 33 29 27 26 26 29 25 22 21 19 19 18 20 22 23 20 27 29 29 27 33 34 41 36 28 28 
34 40 41 42 33 40 33 33 37 31 32 32 27 26 30 28 27 26 23 25 23 22 19 17 19 19 20 24 26 24 28 29 27 28 37 39 38 28 23 22 
35 35 33 38 43 33 31 37 29 37 34 29 27 26 26 24 28 24 24 21 20 29 21 24 25 20 18 25 23 35 33 28 28 27 27 27 32 25 26 27 
40 33 35 31 34 30 39 28 26 33 38 27 26 24 23 26 25 25 26 25 23 23 25 25 26 21 23 22 22 31 30 28 27 25 24 29 26 27 27 27 
42 40 37 36 32 33 31 27 25 31 26 31 25 26 26 27 23 25 24 19 28 23 24 22 21 21 24 22 22 38 26 29 25 25 26 36 27 26 23 22 
32 40 39 30 37 29 28 27 25 26 27 23 28 26 25 25 28 23 25 29 24 37 24 24 19 21 19 21 20 25 26 23 26 25 26 25 30 24 24 21 
38 40 31 38 28 28 26 24 23 25 22 27 24 24 24 28 24 25 26 25 32 23 21 21 22 19 21 22 21 26 22 26 25 25 25 37 24 23 22 23 
32 39 30 36 32 40 40 28 28 28 24 25 24 23 23 23 20 22 19 25 22 25 19 19 19 20 16 20 18 17 27 24 29 27 26 25 27 25 28 29 
37 38 34 39 36 32 29 28 28 28 26 24 23 21 21 21 23 19 18 25 22 20 19 18 17 18 20 17 18 19 26 29 26 27 26 26 24 29 36 31 
35 37 37 32 31 30 29 29 27 27 24 26 22 19 24 20 19 17 17 20 22 19 18 16 22 18 17 18 20 21 26 27 27 28 24 26 31 38 40 41 
36 36 29 36 30 27 29 27 28 28 22 22 20 19 19 18 16 17 16 22 18 20 17 16 16 17 16 20 19 22 27 25 27 27 28 36 38 41 36 41 
29 28 30 38 27 29 28 28 28 36 22 20 19 18 16 16 16 17 15 19 21 16 15 16 16 15 18 21 19 20 24 27 29 28 31 31 34 34 31 38 
29 28 37 41 27 27 23 26 22 21 20 21 18 18 18 16 17 15 14 18 17 13 15 14 14 18 23 23 25 26 27 34 38 33 34 40 30 36 40 33 
33 31 38 38 32 23 26 21 21 21 20 19 18 17 17 15 16 14 12 15 14 15 14 16 17 20 22 26 27 28 37 33 40 35 41 34 41 33 40 40 
28 30 33 27 37 24 21 20 18 18 20 20 17 14 14 16 16 12 09 17 12 13 17 21 23 24 28 29 30 30 30 39 40 32 38 38 40 34 40 41 
37 36 39 25 20 20 18 18 17 19 17 18 15 14 13 13 13 09 09 11 16 15 22 22 25 27 36 31 37 30 39 38 39 33 38 33 31 33 40 31 
30 36 24 20 21 18 18 20 18 16 19 15 14 14 13 14 10 10 08 15 13 19 22 24 25 29 30 29 37 39 33 33 33 38 39 36 40 36 35 30 
28 27 28 29 25 26 26 29 28 28 28 25 27 25 24 22 21 19 21 22 18 20 21 22 22 24 24 28 29 30 32 31 35 41 35 41 39 31 32 33 
28 27 26 28 25 26 28 28 27 26 26 26 24 22 22 21 19 22 22 23 19 21 22 23 23 25 27 36 31 36 32 41 35 37 31 31 38 33 35 42 
26 27 30 28 28 28 30 27 25 28 25 28 22 21 20 19 23 24 26 27 21 22 24 25 26 26 31 38 40 35 34 32 37 40 36 34 31 41 41 35 
28 28 28 27 28 28 26 25 25 25 24 21 22 20 20 23 23 27 27 28 22 24 26 26 27 32 31 35 41 33 36 36 33 40 40 33 42 33 41 43 
26 28 27 26 26 26 26 26 26 22 21 22 21 20 22 22 26 26 29 30 24 25 25 25 31 30 34 34 36 30 35 38 35 35 39 42 34 42 41 44 
27 26 24 25 26 25 27 25 25 22 22 25 25 26 27 26 25 29 29 29 25 25 36 37 32 39 30 38 33 31 37 43 34 34 41 35 33 42 34 40 
25 27 25 26 25 25 26 26 26 23 23 24 27 27 27 27 28 29 30 37 27 28 32 33 39 35 37 40 42 34 38 35 41 42 43 40 42 40 40 41 
26 24 27 26 24 27 25 26 26 23 25 28 28 28 28 27 29 37 33 40 27 39 40 37 38 31 40 43 45 32 44 33 35 39 39 40 42 41 35 41 
24 26 24 26 26 25 28 26 27 26 27 28 28 28 28 36 29 34 39 41 34 32 38 32 39 41 43 45 46 44 35 45 40 40 33 40 33 41 34 42 
24 23 26 26 25 28 26 27 27 27 28 28 28 28 29 28 32 33 40 34 37 36 31 34 34 42 44 45 47 42 46 33 40 39 40 33 34 35 41 34 
25 26 25 25 36 29 31 28 29 36 27 29 28 29 29 36 38 34 40 40 41 41 32 30 30 31 39 38 30 36 40 41 40 34 40 40 39 39 32 32 
25 25 27 28 36 28 29 36 30 30 27 28 29 30 36 36 40 34 34 34 31 31 30 40 34 35 37 36 30 30 33 40 34 39 39 32 40 38 38 32 
27 26 26 28 28 36 28 36 29 29 29 30 37 38 38 34 34 40 33 39 30 33 34 34 38 40 40 37 38 33 34 41 40 39 40 33 36 37 32 38 
26 28 28 36 36 28 31 29 30 30 36 32 38 39 34 32 34 33 33 33 36 41 36 33 34 37 34 39 38 40 34 40 40 33 32 37 32 39 38 32 
27 27 29 37 28 31 29 30 30 38 31 32 38 32 32 40 33 33 38 38 35 40 38 31 35 39 32 38 34 32 34 39 39 38 38 32 31 38 33 32 
28 28 37 30 29 29 28 36 29 29 31 29 31 37 37 38 40 39 33 40 35 33 36 37 37 31 37 33 39 39 32 38 36 36 36 31 38 32 38 38 
29 29 36 36 30 29 30 29 29 29 31 30 37 30 36 39 39 40 35 41 35 37 31 38 33 32 38 33 38 38 31 37 30 31 31 31 32 32 38 38 
28 37 36 29 31 29 29 29 28 28 29 32 37 38 39 34 34 41 35 35 33 40 32 37 37 32 42 33 38 38 38 35 31 37 37 32 32 32 32 32 
32 29 31 29 27 27 28 27 28 36 31 29 39 32 39 34 30 34 35 30 31 35 37 32 31 39 32 39 38 31 37 31 31 37 37 32 33 38 38 32 
28 32 28 27 28 28 28 30 36 29 28 32 32 33 33 30 34 36 30 31 35 31 32 37 32 38 39 31 32 31 31 30 31 30 38 33 32 38 37 39 
29 29 28 27 27 28 28 29 30 30 30 38 32 33 34 41 35 31 37 32 33 32 33 37 32 38 38 31 31 31 37 37 38 37 32 38 38 39 38 33 
