00 00 04 05 00 04 04 12 09 08 08 06 09 09 10 08 14 08 12 13 17 13 23 22 22 20 25 19 23 25 23 38 27 32 34 44 31 56 40 35 
02 02 02 04 02 03 11 08 09 07 07 08 10 11 12 10 08 13 14 13 17 21 22 22 23 23 20 25 25 31 30 28 34 34 32 38 60 35 34 34 
00 04 07 05 09 09 06 08 08 09 07 08 11 14 06 12 13 16 16 21 17 24 23 25 18 23 23 25 25 22 36 34 34 29 55 42 39 30 28 27 
03 05 06 07 07 09 11 09 08 08 09 10 15 16 09 12 15 16 19 22 23 21 26 26 20 24 25 25 28 28 32 37 28 30 47 40 36 27 17 14 
09 09 05 04 09 08 13 09 11 05 08 10 16 16 16 19 17 19 19 14 17 29 28 28 28 29 21 24 19 51 45 32 29 25 24 24 36 21 24 25 
07 07 07 05 05 08 10 12 13 07 11 14 16 17 17 19 19 19 20 21 23 29 28 29 29 25 25 17 17 41 38 30 24 21 20 27 24 25 23 23 
09 05 04 07 06 12 08 12 12 12 13 18 17 18 19 17 20 21 22 21 33 27 27 22 20 21 18 16 16 40 27 29 22 23 24 32 25 22 16 14 
03 07 05 09 11 10 15 12 13 15 16 16 19 18 19 19 18 21 22 34 26 33 23 22 18 16 14 16 15 24 24 18 24 22 24 23 31 17 18 11 
07 04 08 10 10 15 11 13 13 16 16 18 18 18 18 17 21 24 24 29 36 23 22 20 18 14 15 17 15 22 17 23 23 22 21 34 19 15 14 15 
07 10 09 12 22 20 22 19 20 21 15 18 15 16 16 18 14 21 18 26 24 25 23 24 25 24 24 22 22 22 24 19 25 22 21 18 24 16 18 19 
08 11 15 14 22 20 19 21 21 21 16 15 16 16 15 16 20 17 16 25 25 23 25 23 24 24 23 22 21 21 21 25 21 22 22 18 17 19 20 21 
14 12 16 19 19 20 22 22 22 23 17 19 16 14 21 17 19 16 16 23 23 26 24 24 23 23 23 21 20 20 21 20 22 25 16 21 18 21 19 19 
13 17 15 19 21 22 23 24 24 22 17 18 16 15 16 17 14 18 15 24 24 24 26 25 23 21 22 21 20 19 21 20 26 25 22 19 24 19 21 20 
16 14 19 22 23 22 23 22 23 24 18 16 14 14 15 13 16 16 16 23 24 25 23 25 21 22 20 20 19 19 19 23 26 26 21 24 20 20 20 23 
17 18 27 25 22 22 18 22 19 18 15 13 13 13 13 14 18 15 16 24 23 20 19 17 17 20 21 19 19 19 20 31 23 23 23 20 14 18 13 12 
22 20 24 23 25 22 21 18 16 16 12 14 13 13 13 16 15 17 17 22 20 20 17 18 18 19 20 19 20 21 22 25 23 23 23 17 18 12 10 10 
19 28 24 21 26 18 21 16 15 15 12 11 13 14 15 18 17 17 17 22 19 16 18 19 19 21 17 20 20 20 30 23 22 16 14 14 14 10 10 10 
29 22 27 20 16 17 14 16 14 15 11 12 15 15 16 16 20 19 18 18 18 18 19 19 20 20 21 20 21 21 22 29 17 17 12 12 08 11 08 09 
23 30 18 16 17 14 15 15 12 12 11 14 15 16 16 20 17 16 18 17 17 18 19 19 19 21 20 21 20 22 32 18 16 14 13 08 09 09 07 05 
22 21 20 19 21 19 17 15 13 13 11 14 11 12 13 14 12 14 11 11 17 20 16 18 19 21 18 22 17 16 14 13 10 11 12 10 16 10 13 14 
21 21 20 19 19 18 15 13 12 13 12 11 13 11 12 12 15 11 11 11 18 17 19 18 18 19 23 16 16 14 13 11 12 13 14 13 10 14 13 13 
21 19 19 18 17 15 15 12 11 10 12 14 12 11 15 13 11 10 10 10 19 18 18 17 24 21 15 14 12 12 11 09 13 14 08 14 15 13 12 12 
19 16 16 14 14 13 12 11 11 13 12 13 12 12 12 11 10 11 09 09 18 20 17 18 18 14 14 12 10 10 11 12 14 15 15 14 17 14 14 10 
16 16 15 15 12 12 12 11 11 11 13 12 10 10 09 10 09 10 07 07 21 18 17 17 15 15 11 13 11 12 11 13 15 18 13 17 14 11 13 13 
15 14 17 14 12 11 10 10 08 12 11 07 08 07 07 09 12 10 11 12 16 14 12 10 10 11 14 09 09 12 12 07 11 09 09 13 13 13 14 15 
16 14 14 14 12 11 10 08 06 09 09 08 07 07 07 11 09 12 11 11 13 13 10 10 10 11 10 09 08 09 10 10 09 09 10 14 12 15 15 15 
13 16 11 10 13 09 11 07 05 11 07 07 08 08 09 11 14 12 10 10 13 10 09 09 09 13 09 08 05 13 08 09 10 13 14 13 16 16 18 19 
16 09 13 08 07 08 06 06 05 06 08 05 07 08 11 12 13 10 11 10 09 09 09 08 09 08 11 06 06 07 10 08 14 13 15 16 16 19 19 19 
10 15 08 07 07 06 06 05 03 05 04 07 10 08 10 13 11 10 11 12 09 08 09 08 08 12 06 05 05 09 06 12 13 14 14 15 18 18 18 20 
09 08 08 07 07 07 03 05 04 04 08 08 10 08 08 09 07 09 09 09 12 08 18 15 15 13 16 13 16 17 09 13 08 09 09 12 08 16 12 11 
08 06 07 06 05 05 05 04 04 04 08 10 08 08 07 08 09 09 11 12 13 16 15 15 15 15 13 17 17 17 09 10 09 10 08 11 15 11 10 10 
08 08 06 04 07 03 04 05 06 07 09 08 08 08 10 08 07 11 13 14 12 16 15 16 12 15 19 18 18 19 12 08 09 08 15 11 12 09 08 08 
07 03 04 03 02 05 03 06 06 08 07 08 09 08 07 08 10 13 14 16 13 12 15 15 16 17 19 19 20 19 08 12 09 09 10 09 07 08 06 08 
03 05 02 01 02 02 05 07 07 07 08 08 08 07 09 09 12 15 16 16 11 15 18 16 16 18 19 18 20 21 13 08 08 08 07 07 07 09 07 04 
02 02 04 06 04 05 07 08 08 08 07 12 10 11 12 12 12 15 15 15 14 26 19 19 19 19 12 17 12 10 08 06 06 04 04 06 10 05 05 05 
03 04 04 05 08 05 08 08 09 10 08 11 12 14 15 12 15 15 16 17 18 22 19 20 21 16 17 10 09 09 07 06 04 04 04 06 07 05 06 07 
03 04 09 07 07 08 08 10 10 10 13 10 14 13 13 14 15 16 17 18 27 16 18 13 11 13 12 08 07 07 06 04 04 04 05 09 04 06 04 04 
06 06 07 08 07 08 10 09 10 12 11 16 12 14 14 15 16 18 18 18 18 27 14 14 09 08 06 06 05 08 04 04 05 04 05 04 09 05 05 04 
07 06 08 07 08 10 09 11 11 12 16 13 14 14 16 16 17 18 17 18 30 14 13 10 10 06 06 08 06 04 04 04 05 04 04 10 04 05 05 05 
06 07 08 08 09 10 10 12 12 13 15 14 16 15 16 17 18 18 18 19 20 14 14 07 06 05 05 04 06 04 04 04 04 05 05 07 05 06 04 04 
