06 05 06 04 05 05 06 05 05 06 07 05 08 05 04 03 02 02 03 03 03 02 03 02 02 02 05 02 03 03 02 04 02 03 04 05 02 05 03 02 
06 05 05 05 05 06 06 06 07 05 05 08 04 04 03 03 02 03 04 02 02 03 02 03 03 02 03 03 03 03 03 02 04 02 03 03 05 02 02 02 
05 05 03 04 05 06 04 07 08 09 06 05 03 03 03 01 02 04 06 03 02 02 04 05 02 05 01 03 02 02 03 05 03 01 06 03 05 02 01 01 
04 05 06 07 04 05 08 08 09 07 06 05 03 01 02 03 03 07 08 02 02 04 06 07 01 02 05 02 02 03 04 03 01 01 05 05 02 01 00 00 
06 06 05 06 08 08 10 11 12 04 03 11 05 08 09 02 01 07 05 02 03 03 06 04 03 07 05 02 01 05 04 02 02 02 02 00 02 00 00 01 
05 05 06 07 08 09 10 13 13 07 06 05 09 08 08 03 06 05 05 02 03 06 03 03 03 06 03 01 00 03 02 01 02 00 00 00 01 01 01 01 
07 05 08 09 08 10 12 14 14 02 10 09 08 04 03 04 07 05 05 05 05 04 03 02 02 03 02 00 00 03 01 04 01 01 01 02 00 01 00 00 
05 07 07 10 11 11 13 14 15 11 08 11 04 05 03 05 03 06 04 04 03 03 03 02 02 00 00 00 00 01 03 00 03 01 00 00 02 00 00 00 
06 06 09 10 11 13 14 15 17 08 13 06 04 04 05 03 04 05 05 02 03 02 02 02 00 00 00 00 00 01 00 01 00 00 00 02 00 00 00 01 
07 07 07 05 07 07 05 05 03 02 07 07 06 06 07 06 05 04 04 02 01 01 01 02 03 02 05 02 02 03 01 01 02 03 03 02 06 02 03 04 
07 06 07 06 06 05 06 02 03 04 06 06 07 05 06 06 04 04 02 01 03 01 03 03 04 03 03 03 03 03 02 02 03 04 04 03 03 04 04 04 
07 07 03 04 07 05 01 03 03 03 06 09 05 03 05 04 06 03 01 01 01 04 04 05 02 05 02 02 01 01 01 04 05 06 02 06 03 04 02 02 
06 05 05 05 03 01 02 02 02 04 07 04 03 03 04 04 02 02 01 01 04 03 06 06 05 01 05 02 02 01 04 03 05 06 06 03 06 02 03 02 
04 05 03 04 01 02 01 04 03 03 04 04 04 03 03 02 02 01 01 03 02 05 05 05 01 05 02 01 01 01 02 05 06 07 03 07 03 03 01 03 
04 03 05 04 01 01 02 02 01 01 04 03 01 01 01 01 02 01 01 04 03 02 02 00 00 01 01 01 00 00 03 04 02 01 01 03 02 02 00 00 
04 03 03 04 03 00 02 01 01 02 02 02 01 01 02 02 01 01 01 03 02 02 00 00 01 01 01 00 00 01 02 03 01 01 02 01 02 00 01 01 
02 04 03 02 04 03 01 01 01 01 02 00 01 01 01 01 03 01 01 03 02 02 01 01 01 01 02 01 01 02 04 00 01 00 00 02 00 01 01 01 
04 02 04 02 01 01 03 03 02 00 00 01 01 01 02 02 02 03 02 01 00 01 02 01 01 02 01 03 02 01 01 02 00 00 00 00 01 01 01 02 
02 04 01 01 01 03 01 01 01 00 01 00 02 01 02 02 02 01 02 00 01 01 01 01 01 01 02 01 02 01 03 00 01 00 00 01 00 01 00 01 
02 01 01 01 01 01 00 01 00 00 00 00 00 00 00 00 01 01 01 01 00 00 00 00 00 00 03 03 02 02 01 02 01 01 01 01 02 02 02 03 
01 00 01 00 00 00 00 00 00 00 00 00 00 00 00 00 00 01 00 00 01 00 00 01 01 01 03 02 02 02 02 01 01 02 01 02 02 03 02 02 
01 01 02 01 01 00 02 00 00 00 00 00 00 01 00 01 04 01 00 00 00 00 02 03 01 03 04 02 01 01 01 00 02 01 01 02 05 03 03 03 
01 01 00 00 00 00 00 00 00 00 00 00 02 01 02 01 01 01 01 00 01 02 05 04 04 02 03 02 01 01 00 01 00 01 03 03 03 04 03 02 
00 00 00 00 00 00 00 00 01 01 00 00 01 01 00 01 01 00 00 01 02 03 03 04 01 04 01 01 01 00 01 00 02 02 02 03 03 02 03 02 
00 00 00 00 00 00 00 01 01 00 00 00 00 00 00 01 01 01 00 00 02 01 01 00 00 01 01 00 00 00 00 00 01 01 01 02 03 03 04 04 
00 00 00 01 00 00 00 01 00 00 00 00 00 00 00 00 01 00 00 01 00 01 00 00 00 01 00 00 00 00 00 01 01 01 02 02 02 04 03 03 
00 00 00 00 00 00 04 01 00 00 00 00 00 00 00 01 02 01 01 01 01 00 00 00 00 01 00 00 00 01 00 00 01 02 03 02 07 04 04 05 
00 00 00 01 00 01 00 00 00 00 00 00 00 00 01 01 01 01 01 01 00 00 01 00 00 00 00 00 00 00 02 01 04 03 03 05 04 06 05 04 
00 00 00 00 00 00 01 00 00 00 00 00 00 00 00 01 01 01 02 01 00 00 00 01 00 00 00 00 00 01 01 02 03 02 03 03 05 03 04 04 
00 00 00 00 00 00 00 00 00 00 00 00 00 00 00 00 02 02 02 03 00 00 01 02 02 02 05 04 05 05 02 02 01 01 01 02 00 02 01 01 
00 01 00 00 00 00 00 00 00 00 01 00 00 01 01 03 02 03 02 02 00 01 02 03 03 04 03 05 05 05 02 02 01 01 00 00 02 01 01 02 
00 00 00 00 00 00 03 00 00 00 00 00 01 02 01 02 05 03 03 03 01 01 04 05 02 05 07 05 04 04 02 00 00 00 03 01 01 01 02 03 
00 00 00 00 00 01 00 00 00 00 01 02 04 03 03 03 03 04 03 02 02 03 04 05 06 05 07 06 05 03 00 01 00 00 01 01 01 03 02 03 
00 00 00 00 00 00 00 00 00 00 01 02 02 03 04 03 03 02 04 03 02 04 06 07 06 07 05 04 05 04 01 00 00 00 01 00 01 03 03 02 
00 00 00 00 00 00 00 01 01 01 01 01 02 02 02 03 03 04 04 05 03 04 05 04 04 04 03 04 02 02 00 01 01 01 01 01 02 03 04 05 
00 01 00 01 00 02 00 01 00 00 01 02 02 02 02 04 03 05 03 03 03 04 04 04 04 05 03 02 02 02 00 01 01 02 02 04 02 05 03 03 
00 00 00 00 00 00 04 01 00 00 02 03 02 02 03 03 07 04 02 02 05 06 04 03 03 03 05 03 02 02 01 01 02 02 03 03 07 04 03 03 
00 00 00 01 00 01 00 00 00 00 01 02 04 03 02 02 02 02 02 03 04 05 05 04 02 03 02 02 02 02 01 03 04 03 02 03 04 04 04 03 
00 00 00 00 00 00 01 00 00 00 02 03 02 02 02 02 03 03 03 03 05 04 03 03 02 02 02 02 02 02 03 02 02 03 03 04 04 03 03 04 
00 00 00 00 00 00 00 00 00 01 02 03 02 02 02 02 02 03 03 04 04 04 03 02 02 02 02 02 02 02 03 03 03 02 03 04 04 04 03 04 
