39 39 39 40 39 39 42 41 42 42 42 42 43 42 42 42 42 42 43 43 43 46 44 45 46 48 46 52 48 47 46 46 46 45 45 44 43 44 44 44 
39 38 39 39 40 41 41 42 42 42 42 43 42 42 42 43 42 43 44 44 45 44 46 46 46 48 51 47 47 46 46 46 45 43 44 44 43 44 44 45 
39 39 42 42 39 42 44 43 42 43 42 43 42 42 42 42 42 45 46 43 46 45 46 46 51 49 50 47 47 46 45 46 44 43 44 43 47 46 46 47 
40 41 40 41 41 42 43 42 42 43 42 42 42 42 42 42 44 47 49 44 44 47 46 46 50 48 48 47 44 46 44 44 43 42 45 45 44 47 48 49 
39 40 39 39 45 44 44 43 43 42 42 44 43 44 45 45 46 49 49 50 49 46 45 43 43 46 49 45 45 45 44 45 43 44 45 44 45 47 47 47 
39 40 42 41 41 44 43 44 43 43 43 43 45 46 47 45 48 50 51 48 46 46 43 44 44 47 46 45 46 45 44 43 45 45 45 43 47 47 50 51 
42 41 40 42 42 43 44 44 45 42 44 44 47 48 49 48 51 52 53 48 45 42 44 44 44 48 43 45 44 43 44 45 46 46 46 47 45 50 51 52 
40 42 41 43 44 44 44 46 45 44 44 47 49 49 49 52 51 53 53 44 43 43 44 44 45 44 48 44 45 44 45 46 46 47 47 48 50 51 52 53 
42 41 42 44 43 43 44 44 46 44 47 47 48 49 51 50 52 53 61 43 43 43 45 43 44 48 44 45 44 45 45 46 46 47 48 50 50 52 53 54 
42 41 43 41 41 42 41 43 43 43 47 48 51 53 60 60 59 63 59 43 46 43 50 48 47 46 49 47 50 51 44 47 44 44 45 47 42 49 44 43 
42 41 42 41 41 40 43 43 44 45 49 49 54 61 56 55 57 60 60 43 45 50 47 49 48 48 47 51 51 51 45 45 45 43 43 46 48 43 43 43 
41 42 40 40 43 42 42 45 46 47 49 61 56 63 61 59 65 61 55 50 47 45 48 50 46 49 52 52 52 52 47 46 43 40 50 44 47 43 43 43 
42 41 42 40 41 44 43 46 46 49 55 60 57 64 54 54 63 55 62 45 47 47 50 50 50 51 52 52 53 53 44 45 40 40 43 44 40 43 41 43 
41 42 40 41 43 42 45 47 49 48 53 63 64 54 60 57 61 61 62 46 46 48 52 50 51 52 52 52 54 61 46 41 41 40 43 39 42 43 40 39 
41 41 41 41 44 45 48 48 50 51 56 55 65 59 65 61 56 56 62 47 48 59 53 60 61 52 47 51 47 46 42 42 42 41 41 41 44 41 42 43 
41 42 42 44 43 46 49 51 53 54 57 64 65 59 60 55 56 63 65 53 52 61 55 55 55 48 51 46 45 45 42 42 41 41 42 43 42 43 42 42 
42 41 41 44 46 50 47 53 54 55 57 61 54 62 63 56 60 65 67 49 54 53 53 48 46 48 48 45 45 45 41 42 42 41 41 44 43 42 41 41 
41 45 45 47 50 49 60 60 62 63 61 59 57 56 57 63 59 67 68 55 53 54 48 49 45 44 43 46 43 44 41 41 41 41 42 43 44 43 42 40 
43 44 47 49 50 54 53 62 63 65 64 55 62 64 63 64 66 68 69 55 56 50 48 46 46 43 44 44 43 41 41 41 42 42 42 45 42 40 41 40 
46 46 45 45 47 46 43 45 45 45 45 47 47 47 47 48 49 51 48 48 52 51 49 47 47 46 43 45 43 42 41 41 38 38 38 38 38 40 39 39 
45 46 46 44 45 46 44 45 44 46 47 47 47 48 48 47 51 48 48 49 52 50 47 45 45 46 44 42 40 41 39 39 38 39 38 39 39 39 37 37 
46 45 45 44 46 42 49 46 47 46 47 47 49 49 50 51 49 48 46 46 50 50 45 43 46 42 47 42 41 40 40 37 38 38 39 39 42 38 36 36 
45 42 42 40 43 47 43 49 47 47 48 49 49 50 50 48 48 45 45 47 47 46 46 43 42 43 39 42 40 39 37 39 38 38 39 39 37 36 36 36 
42 43 41 41 46 42 47 46 49 47 49 49 50 50 48 49 46 47 46 45 46 44 42 41 40 39 41 41 40 37 39 37 38 39 36 37 37 36 35 35 
41 42 45 44 46 46 46 47 46 48 47 49 47 46 46 46 46 45 44 44 44 45 42 42 42 40 40 39 37 37 37 35 36 34 34 36 37 35 35 35 
43 43 45 45 45 45 47 46 47 48 47 48 46 46 46 45 45 44 43 43 44 43 42 41 41 40 40 37 37 36 37 36 34 34 34 36 36 35 36 36 
43 46 43 44 47 47 44 47 48 47 48 47 46 44 44 46 44 43 41 41 44 43 41 38 38 40 38 37 36 37 35 37 35 35 35 37 34 36 35 35 
46 44 47 45 46 46 47 48 48 48 46 47 44 44 44 44 43 42 41 41 40 42 38 38 38 37 38 38 36 35 35 34 37 35 34 34 36 34 35 36 
45 47 44 46 46 47 47 49 50 46 47 44 44 42 43 44 41 41 40 40 43 39 39 39 38 38 36 36 35 35 34 35 34 34 34 36 34 36 37 37 
45 45 45 45 45 45 47 46 46 46 44 43 42 40 40 40 38 38 37 37 39 38 38 38 38 37 39 36 37 37 34 34 33 31 31 32 28 33 31 31 
45 44 45 44 46 46 46 46 45 45 43 43 40 40 39 39 39 37 38 38 39 38 38 38 38 36 36 37 37 37 33 34 31 31 29 30 32 31 32 32 
45 45 45 46 45 47 49 45 42 42 43 40 39 38 40 38 37 38 38 39 38 37 38 38 36 38 38 37 35 35 34 31 30 28 34 30 32 32 33 34 
45 46 46 48 48 45 45 42 42 42 40 40 39 38 37 37 37 39 38 39 38 37 37 38 39 37 38 35 36 35 30 31 29 28 29 32 29 32 32 36 
46 46 47 47 44 46 43 43 42 42 40 38 39 38 37 37 37 38 37 38 37 37 40 39 37 39 36 36 35 36 32 28 29 28 31 28 32 34 33 34 
46 45 45 46 44 43 42 40 39 39 38 41 38 37 37 37 37 38 36 36 37 38 37 35 35 36 35 34 32 32 29 33 32 33 33 32 33 35 35 35 
45 46 44 45 44 40 41 39 39 39 38 39 37 38 39 37 38 36 36 36 38 37 35 35 35 35 35 32 33 33 30 32 33 33 34 33 34 35 35 35 
45 45 47 44 41 41 38 38 38 38 41 37 38 36 36 37 37 36 36 36 38 36 35 34 34 34 30 32 32 33 33 34 34 33 33 34 37 35 34 34 
45 43 42 40 39 39 39 38 38 38 38 40 37 37 36 37 36 36 35 36 36 36 36 34 33 31 33 33 33 33 33 35 33 33 33 35 35 33 34 35 
43 42 41 39 38 39 38 38 38 38 41 37 37 35 37 36 35 36 36 35 37 34 33 32 32 33 32 33 33 33 35 33 33 34 34 35 34 35 34 35 
41 40 39 38 38 38 38 38 38 38 38 37 38 36 36 35 35 35 35 35 35 34 33 32 32 33 33 33 33 33 34 33 34 33 34 34 34 35 35 35 
