70 69 69 68 68 68 66 68 67 67 68 66 69 67 67 66 66 66 67 67 67 67 66 66 66 67 67 69 69 69 70 69 72 71 71 70 69 69 69 70 
69 68 68 67 67 67 67 67 67 66 67 69 67 67 66 66 59 67 68 67 66 67 66 67 66 67 68 69 70 69 70 72 71 69 70 70 69 70 70 70 
69 69 67 66 68 66 68 68 69 69 67 67 67 66 66 66 69 69 70 67 67 59 67 67 68 68 70 71 71 72 70 72 69 69 70 68 70 71 72 72 
68 66 67 66 68 68 67 70 70 68 68 67 66 66 67 67 67 70 72 66 68 68 68 68 69 69 70 72 73 72 71 70 69 67 70 69 69 72 73 74 
69 68 68 69 59 66 69 72 73 66 66 71 68 69 70 68 67 70 68 68 68 68 70 71 71 70 72 75 76 69 68 75 71 73 74 69 68 73 72 72 
68 69 66 68 70 68 70 73 73 68 68 68 70 70 70 66 70 68 69 68 68 68 71 71 71 73 73 77 77 72 71 71 74 73 73 69 72 72 71 71 
67 67 70 69 70 70 75 74 74 66 71 70 70 68 67 69 66 69 69 68 68 74 72 74 75 74 79 78 79 68 75 76 74 72 72 70 75 72 72 72 
67 69 69 71 71 74 74 75 75 72 69 73 69 69 66 67 68 69 69 69 72 71 75 74 75 77 77 79 79 77 75 78 75 74 70 73 70 72 71 72 
69 68 70 70 73 73 75 75 76 70 74 69 67 66 68 68 68 71 69 71 70 74 73 76 75 77 79 79 80 74 79 74 71 72 72 70 72 71 70 70 
69 69 69 68 69 69 66 68 67 67 69 70 69 69 70 70 72 71 70 72 72 72 71 69 69 70 67 72 70 69 74 74 73 71 71 71 67 68 66 66 
69 69 69 68 67 69 68 67 67 67 68 69 70 70 71 69 71 70 71 72 70 72 69 69 68 70 71 69 69 69 74 73 71 69 69 67 69 66 66 67 
69 69 67 66 69 66 68 67 68 68 69 68 70 70 70 72 71 71 70 72 72 67 68 68 72 68 72 69 70 71 73 75 69 68 71 67 65 66 67 68 
68 66 66 64 66 66 59 68 67 69 69 70 70 71 72 70 72 70 70 71 69 70 69 68 68 69 67 72 70 70 71 70 70 68 66 66 59 68 67 69 
66 67 58 59 66 59 67 68 67 68 70 70 72 73 70 72 70 71 70 68 71 67 68 67 68 66 70 70 70 68 71 69 67 66 59 59 66 68 68 68 
59 65 67 66 66 66 67 67 66 66 69 69 69 69 69 70 71 71 71 69 68 71 68 68 68 68 69 67 66 66 69 69 66 66 66 66 68 67 67 67 
66 58 66 67 66 66 68 66 68 69 69 69 69 69 70 71 71 72 72 70 68 69 68 69 69 66 69 66 67 67 66 67 66 67 67 67 68 67 68 69 
65 67 66 66 67 68 64 67 67 67 69 68 69 70 71 71 71 72 72 68 71 67 68 66 66 69 64 66 59 65 68 64 66 59 65 68 58 67 67 68 
67 59 67 65 66 59 68 66 67 69 69 70 72 71 71 72 72 71 72 70 68 70 66 67 66 66 67 65 65 66 64 67 58 65 66 67 69 67 68 69 
65 67 59 66 66 68 66 69 67 69 69 70 71 71 71 72 71 72 72 67 71 67 67 66 67 68 64 66 65 65 67 58 66 67 67 69 67 69 68 69 
59 59 64 64 65 58 57 62 62 56 61 57 54 61 62 63 55 64 62 62 68 68 68 66 66 67 64 67 66 66 67 66 68 66 66 66 58 68 68 68 
58 58 58 58 64 58 56 62 61 62 62 61 56 62 55 61 64 56 56 62 67 68 66 66 65 59 67 66 67 66 67 68 66 66 65 66 66 68 68 69 
59 58 58 57 57 62 58 61 55 60 56 61 55 60 59 57 62 56 56 62 68 68 66 64 68 65 64 67 69 68 67 66 65 65 67 59 70 70 71 72 
63 56 61 54 56 56 61 56 61 56 54 57 61 61 56 54 61 62 61 56 66 66 63 63 64 59 66 70 69 67 59 66 66 59 59 69 67 72 72 73 
56 55 61 62 55 55 61 61 60 55 63 55 55 61 59 61 61 62 62 55 66 64 64 58 59 65 67 70 69 65 66 65 65 57 68 66 71 72 73 73 
55 55 63 61 55 61 60 60 64 61 54 59 64 57 57 54 57 61 55 55 65 66 66 67 68 67 69 70 70 65 66 70 70 72 73 70 70 74 73 73 
62 56 62 55 54 60 54 64 64 60 54 65 63 59 54 65 56 61 57 64 59 66 68 68 69 68 70 71 72 67 69 69 73 72 72 71 72 73 73 73 
61 63 65 65 55 54 59 64 58 54 64 62 65 60 61 57 59 63 63 63 66 67 69 69 69 71 68 72 73 67 71 74 73 72 72 72 76 74 74 74 
57 65 56 65 58 57 58 64 57 57 58 58 54 54 62 62 65 63 58 64 67 68 68 69 70 71 73 73 74 73 73 74 72 72 72 74 73 74 74 75 
54 63 64 58 64 58 63 64 57 64 64 65 61 54 62 59 56 58 65 66 68 68 70 71 71 73 72 74 73 73 74 72 72 72 73 72 74 74 74 74 
65 65 58 58 59 64 59 63 63 58 59 60 61 54 54 61 60 58 64 58 67 68 69 70 70 70 72 72 72 73 73 73 73 74 75 75 78 75 75 75 
64 65 58 58 59 63 64 64 65 60 54 62 54 55 60 62 63 64 59 66 69 69 70 71 71 72 72 73 73 73 74 73 75 76 76 74 76 75 76 77 
65 64 64 64 64 58 61 65 59 60 55 63 60 54 63 62 66 66 67 68 69 70 71 72 71 73 73 73 72 72 73 74 76 77 75 78 74 76 75 75 
64 64 64 58 57 63 65 65 54 61 54 55 60 60 62 58 58 67 67 69 70 71 74 73 73 73 73 71 72 73 74 76 76 78 78 74 79 76 76 75 
64 64 58 59 56 65 58 61 56 62 61 59 61 54 58 57 66 68 68 69 71 72 72 72 72 73 72 73 73 74 75 77 78 79 77 79 75 75 75 75 
58 64 59 58 58 65 54 61 61 61 61 65 65 66 67 59 66 69 69 70 71 72 72 72 72 72 73 72 72 72 75 74 75 75 75 75 75 74 74 75 
64 64 58 64 64 58 55 61 56 63 64 58 67 67 67 66 68 70 70 70 72 72 72 72 72 71 73 72 73 74 75 74 75 74 74 73 75 75 76 76 
58 59 57 64 54 55 60 57 57 63 66 67 67 66 66 68 71 70 70 71 72 75 72 72 72 73 70 73 73 73 74 77 75 75 76 75 73 75 76 77 
58 58 59 65 60 61 56 62 57 59 66 68 59 67 67 69 70 71 71 71 72 72 72 72 72 71 73 73 73 74 76 74 77 75 75 75 76 77 77 77 
57 59 64 59 54 56 56 58 58 59 68 67 67 67 69 69 71 71 71 71 72 72 72 73 72 73 72 74 74 74 73 75 74 74 74 76 76 76 78 77 
64 65 65 60 61 62 63 65 59 66 67 67 69 68 69 70 71 71 71 72 72 72 72 72 72 73 73 74 74 75 74 75 74 75 75 76 77 77 77 78 
