13 13 12 14 14 13 15 12 13 14 14 14 15 15 15 15 15 15 13 13 12 11 10 11 11 09 14 09 11 12 12 10 11 10 10 08 09 07 09 10 
12 13 13 13 14 13 13 14 14 14 13 14 15 15 15 13 16 13 13 12 12 11 11 12 12 12 10 12 12 11 11 11 10 09 09 08 07 10 09 09 
13 12 16 15 12 14 14 14 13 14 14 16 15 15 16 16 12 12 11 12 10 10 12 13 08 13 13 13 11 12 10 10 09 09 07 08 11 10 10 10 
14 15 13 16 13 13 14 13 14 15 14 15 15 15 14 14 14 11 10 11 11 11 14 15 10 12 13 11 12 11 09 09 09 08 09 09 09 10 11 12 
12 13 13 15 16 15 14 14 13 15 15 15 14 11 11 14 13 10 08 09 11 09 13 10 10 16 14 13 13 08 08 11 09 09 10 10 08 11 10 10 
12 14 14 14 15 15 14 13 13 15 13 15 11 11 12 13 11 08 07 09 10 13 10 11 12 16 13 13 12 09 10 10 10 10 10 10 10 10 10 10 
14 14 17 16 14 14 15 14 14 15 15 09 10 08 08 11 09 07 05 13 11 09 11 11 12 12 15 13 13 08 11 09 09 07 07 09 11 10 09 09 
15 14 14 15 14 14 14 15 15 14 10 12 08 08 08 07 07 06 05 10 10 10 11 11 13 13 11 12 12 11 09 11 07 08 08 08 08 08 09 11 
14 14 14 14 14 13 15 15 14 12 13 08 09 06 07 08 06 06 04 09 09 10 13 12 11 10 12 13 13 09 12 08 08 08 08 08 09 11 09 10 
14 13 13 14 11 10 10 09 08 08 09 08 07 05 05 04 02 02 01 10 08 09 06 06 06 06 03 06 04 04 09 09 10 10 10 10 13 11 11 12 
13 13 12 12 10 09 10 08 08 08 07 08 05 04 03 02 03 01 02 09 09 07 06 05 04 06 06 04 04 04 09 10 10 11 11 11 12 12 13 14 
12 12 15 12 10 10 09 08 08 08 08 04 03 02 04 02 01 02 03 07 08 07 05 03 07 04 06 04 04 04 10 09 12 13 10 13 10 14 13 13 
12 11 11 10 09 09 09 09 08 07 03 04 03 02 01 01 01 03 03 08 05 06 03 03 03 04 02 03 03 06 10 12 14 14 13 11 15 12 14 15 
09 11 11 10 09 09 08 07 07 06 05 02 02 01 01 01 02 03 04 05 06 04 03 02 03 01 03 05 05 05 11 12 13 15 12 15 13 15 14 16 
10 09 09 08 08 07 07 06 05 05 02 05 03 04 05 01 01 03 03 04 03 02 02 02 03 03 07 06 08 09 11 12 13 13 14 13 14 16 16 16 
09 08 08 08 07 07 06 05 04 04 03 03 05 03 03 02 02 03 01 03 03 02 03 03 03 05 06 09 10 10 11 12 14 14 14 14 15 16 17 18 
09 09 08 07 06 06 07 04 03 03 05 06 03 02 02 02 05 02 01 03 01 03 04 04 05 07 08 10 09 09 12 16 15 14 14 15 16 18 19 19 
08 06 07 06 05 05 04 04 03 03 03 05 03 02 01 01 01 02 01 01 02 02 03 04 07 09 10 08 10 11 14 13 13 14 15 16 17 19 19 20 
06 07 05 05 04 04 04 03 02 03 05 03 01 01 01 01 02 01 00 02 01 03 06 07 07 10 09 10 12 12 13 14 15 15 16 17 18 19 19 21 
06 05 08 09 05 07 07 10 09 09 10 07 13 11 11 08 13 07 11 13 03 03 06 07 08 07 13 10 14 15 17 16 20 19 19 19 21 22 23 24 
07 07 06 07 06 07 10 09 10 08 10 11 11 11 12 12 07 13 13 13 03 05 08 09 10 09 10 15 16 15 17 19 19 20 20 21 21 24 23 23 
05 07 11 09 09 09 07 10 10 12 08 15 12 13 06 10 14 14 14 14 04 08 10 12 07 13 15 17 17 19 18 18 20 21 20 22 26 24 23 23 
09 08 09 10 08 08 09 10 10 09 13 08 13 12 12 13 15 15 16 14 07 08 10 12 15 15 18 17 18 18 19 19 20 21 23 24 24 24 24 23 
08 09 09 07 08 09 09 12 10 09 07 12 13 12 14 15 15 14 16 18 07 11 14 15 17 18 17 17 18 19 19 20 22 23 23 24 24 23 23 24 
08 08 06 08 08 09 12 13 15 11 11 16 15 16 16 15 12 16 15 15 10 10 13 13 13 17 17 20 21 19 20 25 24 24 24 24 21 22 20 20 
07 08 07 09 11 11 12 16 16 13 13 15 16 16 16 13 15 15 15 15 09 13 13 16 17 18 19 21 23 22 22 24 24 24 24 22 22 20 19 19 
08 06 11 12 11 13 18 18 18 12 16 19 16 15 15 13 15 15 16 16 12 11 16 19 20 18 22 24 27 21 26 24 23 20 19 21 21 19 18 18 
06 11 09 14 15 18 18 20 20 18 16 18 16 15 14 15 12 15 15 18 13 15 18 19 22 24 23 28 28 26 22 25 20 20 19 19 18 18 17 18 
09 08 14 14 16 18 19 18 18 16 18 16 14 14 14 11 15 17 16 17 14 17 20 21 22 22 26 27 28 24 26 21 21 19 19 18 18 18 18 17 
11 12 12 09 16 16 11 13 11 11 15 16 13 15 16 16 19 17 15 15 14 16 14 13 13 15 13 17 15 14 22 20 20 20 20 19 21 18 19 20 
11 11 14 11 13 13 13 11 11 12 16 14 16 17 17 16 18 15 16 17 14 15 13 14 13 14 17 14 15 16 20 21 20 20 20 18 19 20 20 20 
13 13 07 09 16 11 12 12 14 15 15 14 17 19 17 20 13 15 12 11 16 13 14 12 17 15 14 15 15 15 20 19 20 21 18 20 20 20 19 19 
11 08 10 08 10 13 10 15 14 16 16 18 20 20 19 13 17 11 12 12 13 15 11 12 14 14 13 13 14 17 20 20 21 21 21 20 21 19 20 20 
09 11 07 09 12 09 13 14 15 14 18 18 19 20 14 18 12 14 12 12 15 12 13 13 13 13 14 17 15 15 19 20 22 22 20 21 20 20 20 22 
08 09 15 13 12 13 12 14 12 12 16 12 12 11 11 12 14 13 14 15 13 13 13 13 14 13 17 16 16 17 20 21 20 19 19 20 19 21 20 20 
11 11 13 13 13 12 14 12 12 13 15 12 11 11 11 13 12 15 14 14 13 13 14 14 14 16 16 17 18 19 20 20 19 20 20 20 20 20 20 20 
10 16 11 11 16 13 12 12 12 13 11 12 11 12 13 14 17 14 14 14 13 14 14 15 16 17 16 18 17 17 21 19 20 20 21 20 22 21 20 20 
16 11 16 12 11 11 12 14 12 12 11 10 14 13 13 14 15 15 14 13 14 14 16 16 16 17 19 16 18 19 20 21 22 21 20 21 19 19 20 22 
13 17 11 11 12 12 12 12 11 11 09 12 12 13 13 15 14 13 15 14 14 15 15 16 16 19 17 19 19 20 21 20 20 19 20 19 20 21 21 21 
12 13 11 11 11 12 12 11 11 11 11 13 12 13 14 14 14 14 13 14 15 16 16 16 17 18 18 20 19 20 21 21 20 20 20 19 20 21 22 22 
