37 31 38 30 31 38 28 39 33 39 40 39 41 39 39 39 33 38 33 39 40 40 41 35 41 41 30 36 30 36 36 39 33 33 33 35 30 44 39 32 
31 37 31 36 29 37 37 39 32 39 32 35 39 39 39 33 39 39 35 33 41 41 35 35 41 30 30 30 31 37 33 39 39 32 37 39 43 38 33 34 
31 38 28 28 39 29 35 33 34 35 34 39 39 33 39 33 38 41 36 41 35 41 36 30 36 31 41 38 39 31 40 40 32 30 44 39 40 39 34 41 
29 31 36 27 34 38 30 40 34 34 34 40 39 39 32 32 41 31 39 41 41 30 30 37 41 37 32 33 40 32 34 33 30 35 42 40 39 35 39 33 
33 37 38 37 26 28 32 41 30 33 33 31 39 40 35 35 41 37 31 41 35 38 31 31 37 32 32 39 33 43 34 42 32 39 39 41 33 32 31 31 
32 30 29 36 38 37 34 37 31 35 40 35 35 36 36 34 38 31 38 30 37 38 37 32 39 38 33 33 33 42 42 32 39 38 32 30 39 37 39 40 
29 36 30 36 34 34 32 32 39 39 31 38 35 35 36 37 34 32 38 30 32 35 38 38 38 33 32 33 34 38 40 43 33 31 37 40 41 39 33 39 
30 37 39 40 40 30 33 34 40 30 35 33 37 37 41 35 37 36 32 38 30 33 38 32 38 39 34 42 41 41 34 40 37 38 37 31 35 33 33 39 
36 32 33 33 36 38 39 39 35 35 33 41 35 31 30 31 31 34 40 32 33 31 38 33 33 39 40 41 35 33 34 33 31 30 32 42 32 39 32 33 
38 33 39 36 36 36 31 30 30 36 30 31 30 31 32 38 38 33 38 31 37 37 38 33 34 33 42 34 34 35 39 39 40 40 34 39 44 41 42 43 
38 41 40 31 30 31 36 36 37 32 36 36 38 31 32 38 33 32 39 37 33 32 34 40 35 41 34 41 35 35 39 34 34 41 42 42 41 43 42 42 
34 40 39 32 30 31 30 31 31 38 31 32 31 38 33 39 31 38 32 38 38 34 34 41 33 41 43 41 39 33 39 40 42 43 39 43 45 43 35 40 
41 36 41 36 37 38 32 32 32 38 31 32 40 33 32 39 33 33 33 38 33 40 42 42 42 42 42 40 40 39 40 41 41 43 45 43 45 42 42 39 
35 35 31 37 32 32 37 32 37 33 32 32 31 38 31 39 32 33 33 33 33 35 41 35 35 42 40 40 34 34 40 42 44 45 43 45 42 34 34 35 
36 30 38 36 38 38 37 32 31 31 37 31 33 39 39 39 34 34 35 40 40 35 40 39 33 34 34 33 31 37 41 42 35 39 33 42 34 40 33 39 
31 37 32 37 30 37 38 31 31 38 33 38 39 33 33 39 33 42 40 40 33 41 33 33 39 39 34 31 38 33 39 42 39 34 40 42 34 33 31 37 
31 32 40 41 38 31 39 32 32 38 37 42 34 39 33 34 44 35 35 40 41 39 33 37 37 39 36 32 38 32 42 38 39 32 32 33 40 32 32 38 
31 36 32 31 37 38 37 37 37 33 34 38 33 33 34 35 35 35 35 40 39 33 36 37 38 37 32 31 32 39 34 40 38 38 33 39 38 33 38 37 
30 32 36 37 31 37 37 38 32 32 31 33 40 34 34 35 35 40 42 38 40 37 32 37 37 32 37 33 32 33 35 38 39 32 38 32 38 37 31 37 
36 36 30 31 30 30 39 34 32 38 31 39 31 39 40 35 37 31 41 41 31 32 31 31 37 38 37 39 37 31 36 37 35 36 37 31 35 33 34 35 
36 30 36 36 34 33 40 32 38 32 38 31 40 40 35 40 31 35 30 30 37 37 37 37 37 37 33 31 31 37 36 30 31 32 39 32 33 35 34 40 
30 36 32 41 30 39 33 32 38 31 33 39 35 35 30 38 35 35 40 40 38 31 37 31 39 38 38 31 31 30 36 40 39 33 37 35 42 40 38 37 
30 35 33 38 32 32 31 32 31 39 39 41 40 30 31 40 31 35 40 39 31 32 31 37 32 36 37 37 36 30 36 32 32 40 42 40 41 38 32 37 
33 34 32 38 37 37 37 32 31 39 35 41 36 32 34 31 34 34 39 33 38 37 31 37 37 31 36 37 36 31 38 38 35 42 40 42 39 32 32 32 
39 32 35 39 37 31 31 30 28 40 34 31 38 38 38 39 35 40 41 30 30 31 30 41 35 36 37 35 34 31 37 30 32 38 32 38 33 32 33 33 
40 38 33 32 32 29 37 28 29 38 31 32 38 32 38 34 39 36 35 41 31 30 41 35 41 35 30 40 41 36 38 31 32 36 36 37 38 39 33 33 
38 40 38 31 39 31 26 29 28 40 37 38 38 32 33 35 38 36 41 35 36 35 35 35 41 31 39 41 41 32 30 35 37 38 38 38 33 33 32 32 
34 30 33 37 29 29 36 28 28 30 31 36 37 38 41 30 36 41 30 41 35 36 36 41 40 40 36 36 41 31 39 36 39 32 32 39 38 37 32 34 
32 40 30 29 36 36 27 29 27 29 29 38 34 40 41 30 36 41 30 37 30 41 40 41 40 36 34 41 35 37 36 32 37 38 31 38 32 39 32 34 
36 30 36 29 33 38 33 37 38 38 37 38 33 34 35 35 33 37 38 39 36 41 37 36 30 30 30 31 37 31 32 38 31 32 33 33 42 42 42 42 
36 37 31 31 33 38 32 38 39 34 37 33 41 30 37 30 38 33 33 40 34 31 30 36 36 35 37 31 38 32 36 32 39 34 34 35 41 42 35 41 
31 30 29 37 32 39 30 39 33 39 33 33 31 39 30 40 38 33 31 31 30 30 36 30 37 31 38 32 39 34 32 36 34 42 34 43 45 42 33 32 
30 29 37 31 32 32 34 33 40 34 40 37 34 34 34 38 41 37 38 31 35 30 37 30 31 33 38 34 40 34 39 35 43 43 44 35 42 39 39 38 
30 30 31 33 38 34 33 34 40 41 36 32 34 41 39 35 38 38 37 32 30 30 31 30 37 32 33 39 34 34 40 41 43 43 35 43 40 39 38 39 
30 30 39 40 33 33 33 41 40 40 30 31 32 38 32 38 31 37 30 30 30 33 39 39 33 39 38 32 37 37 40 39 34 33 33 33 40 31 37 31 
31 39 33 33 35 39 34 40 34 41 37 31 38 31 37 32 31 36 30 37 37 33 39 33 39 38 33 37 32 32 34 39 33 37 37 32 33 37 38 32 
31 39 41 34 35 40 35 41 41 30 31 34 37 37 31 37 37 37 31 31 34 39 33 37 37 33 41 37 37 37 33 41 32 37 37 33 41 37 37 37 
40 33 35 41 34 41 35 36 30 30 31 37 32 31 31 38 37 37 37 38 38 35 38 32 36 30 37 31 31 32 40 31 32 37 37 30 32 36 31 38 
40 35 34 40 41 40 41 36 36 30 37 37 37 31 37 37 37 37 37 31 35 38 37 37 37 31 30 32 32 38 31 32 31 30 36 38 30 32 38 33 
33 40 40 34 35 41 30 36 36 31 31 31 31 37 37 31 31 31 38 38 39 32 32 30 36 31 31 32 38 38 37 37 30 36 30 31 31 39 32 33 
