35 35 34 36 37 36 37 35 37 38 39 39 43 41 41 41 41 43 42 42 41 41 39 38 38 38 35 37 34 34 34 32 34 31 31 30 30 29 32 33 
34 35 35 35 37 37 35 38 38 38 41 42 41 41 41 41 42 42 42 41 40 39 38 36 36 36 37 34 35 33 33 34 31 31 30 32 28 33 33 33 
36 35 39 38 35 36 39 40 41 41 41 44 42 42 42 42 43 42 42 40 40 41 37 34 39 35 33 34 35 35 32 32 31 30 29 29 35 34 35 36 
37 37 35 37 37 38 38 41 43 42 42 42 42 41 42 42 42 42 42 40 38 38 34 33 36 36 35 35 35 33 33 31 30 30 32 32 32 36 38 39 
34 35 36 37 38 39 40 42 42 41 41 46 43 43 44 42 40 40 38 41 38 37 35 36 36 33 36 37 38 30 30 35 33 35 36 32 32 38 37 37 
35 36 37 37 40 39 42 43 45 43 44 44 44 43 43 40 41 38 38 39 39 34 36 35 35 35 36 39 39 32 33 32 36 36 36 33 36 37 38 39 
36 37 38 39 42 41 41 45 48 41 46 44 42 39 38 40 36 37 37 36 35 39 36 36 36 37 41 39 38 30 35 38 37 37 37 35 39 39 40 41 
38 40 41 42 43 43 45 49 49 47 42 46 40 40 37 37 37 37 36 35 37 35 37 37 36 39 39 37 38 37 36 39 39 38 36 38 38 41 41 42 
39 40 41 42 44 44 47 48 49 42 47 41 39 38 38 37 36 37 37 35 35 37 36 36 37 39 38 39 39 38 39 38 36 38 38 37 40 41 40 42 
41 39 41 41 36 37 35 37 34 33 41 40 41 41 41 39 44 38 40 36 36 36 37 36 36 36 35 35 35 35 37 38 37 38 38 39 41 42 42 42 
41 40 38 39 35 35 38 33 35 36 40 40 41 41 42 40 39 41 41 36 37 36 36 35 35 35 36 35 36 37 36 37 38 39 39 39 42 42 42 43 
38 39 42 38 39 36 32 34 34 34 39 43 42 43 38 42 41 41 39 36 36 39 36 35 36 35 33 36 36 37 38 37 40 42 40 42 42 42 41 41 
40 38 38 37 34 33 33 33 33 36 41 40 43 43 43 40 43 40 40 36 37 35 35 35 34 34 36 36 37 38 39 41 43 43 43 41 43 40 41 42 
37 38 36 34 33 33 32 36 34 34 39 43 44 44 41 44 40 39 38 36 35 36 35 35 34 35 36 38 37 38 41 41 42 43 40 43 41 42 42 42 
37 36 34 35 33 33 36 34 35 35 40 41 40 40 40 40 38 38 37 36 35 37 35 34 34 36 36 39 39 39 40 38 40 40 40 41 43 42 43 43 
35 35 33 35 34 33 35 35 36 37 41 40 40 39 39 37 39 37 38 36 36 36 34 36 37 38 37 39 39 39 40 39 40 40 40 42 42 43 44 45 
35 33 36 35 33 36 33 36 35 35 40 41 39 37 37 38 37 38 37 35 37 33 36 35 35 37 42 39 39 39 38 41 40 41 42 43 43 45 45 46 
33 33 32 34 34 34 38 34 36 37 38 39 37 37 37 37 37 36 37 36 35 37 34 36 37 39 38 39 39 39 40 39 42 42 43 43 45 46 46 46 
33 32 34 34 34 38 35 37 35 38 39 38 38 36 37 37 37 38 37 35 37 35 37 36 38 38 39 39 40 39 38 41 42 42 43 45 45 46 47 47 
33 33 35 36 33 35 34 40 38 37 37 36 36 36 36 35 36 36 37 37 35 35 37 36 36 35 38 36 36 37 36 39 36 35 35 38 34 42 39 39 
34 33 34 35 33 35 38 37 37 36 35 36 36 36 36 37 35 37 37 38 35 36 36 36 37 35 36 37 37 38 36 37 35 36 34 38 41 39 38 38 
33 35 38 36 38 36 40 37 37 37 36 37 36 37 35 36 40 39 39 39 35 37 37 38 35 37 36 37 36 36 39 35 35 33 41 37 41 38 38 38 
36 36 36 35 37 36 35 38 36 36 35 36 38 37 37 39 38 39 39 39 36 36 38 38 37 36 38 36 37 38 35 38 33 34 37 38 35 38 37 39 
34 36 35 34 35 35 37 37 37 34 36 37 36 36 38 37 39 39 39 40 36 37 38 39 36 38 36 37 38 35 39 34 34 34 36 34 38 39 36 36 
35 35 34 34 35 35 37 36 36 35 35 36 38 38 38 38 39 40 40 40 36 38 36 35 35 36 35 37 37 35 35 35 36 36 37 37 40 38 39 40 
34 35 34 33 34 36 36 36 37 35 37 37 38 38 38 38 40 40 41 41 36 37 35 36 37 35 36 37 35 35 35 36 37 37 37 38 38 40 40 40 
35 34 34 34 35 37 35 37 36 36 37 41 39 39 39 39 39 41 42 43 38 34 36 35 35 36 39 36 35 36 35 37 37 38 39 40 41 40 38 38 
34 33 34 34 35 36 38 35 36 38 39 38 40 39 39 39 41 42 42 44 34 38 35 35 35 35 35 35 35 35 36 36 39 38 39 40 41 38 39 38 
33 34 34 35 35 38 35 37 37 39 38 39 39 38 39 40 41 43 43 44 38 34 35 34 35 35 36 35 34 36 36 37 38 39 39 41 39 39 38 39 
33 35 34 35 43 41 43 39 39 40 37 39 36 36 36 38 34 40 37 36 35 35 35 35 35 35 34 36 36 36 37 36 38 39 40 39 44 40 41 42 
33 36 38 39 43 41 40 40 41 41 38 37 36 36 35 37 39 36 36 36 36 35 35 34 34 35 35 36 35 35 36 38 40 41 42 41 41 42 43 44 
38 36 36 39 40 41 38 41 41 41 39 36 36 34 40 36 38 36 36 37 35 36 34 33 35 34 38 36 37 38 37 39 42 43 39 44 39 43 41 41 
36 37 38 41 41 40 42 41 42 42 36 38 36 35 36 35 34 37 35 37 35 34 34 33 34 36 35 39 37 37 41 40 42 44 44 41 46 41 43 42 
37 37 40 43 41 42 41 42 41 43 38 35 34 33 34 33 35 37 34 34 34 33 33 34 36 34 37 36 36 37 39 42 45 45 42 46 42 43 43 44 
38 38 46 45 41 41 38 42 40 39 35 35 35 35 35 34 37 35 35 35 34 34 35 35 35 36 37 38 39 39 41 43 43 43 43 42 41 42 40 40 
42 42 43 44 45 41 41 39 37 37 35 34 35 34 34 34 36 35 36 37 35 35 35 36 36 37 37 39 39 39 41 42 43 42 42 40 42 40 41 42 
39 46 45 42 45 39 43 38 37 37 35 38 35 34 34 37 33 36 34 34 35 36 36 37 38 38 40 40 41 41 43 45 43 41 40 42 40 41 42 43 
48 42 46 40 38 38 36 38 36 37 36 35 35 35 34 34 37 34 35 35 36 36 39 38 38 38 40 42 41 41 42 43 40 41 41 41 42 44 43 43 
44 48 39 38 39 36 37 37 35 35 35 35 34 34 35 38 34 36 35 36 36 37 37 37 38 39 40 40 41 41 43 42 41 42 41 41 42 42 44 42 
42 42 38 37 37 36 36 35 36 35 35 35 35 34 35 36 35 37 35 36 37 38 38 38 39 40 41 41 41 42 42 41 42 41 41 42 43 42 43 43 
