13 12 13 11 12 12 12 13 12 12 10 11 08 08 09 09 08 10 09 09 09 11 10 11 12 14 14 17 15 15 14 15 13 14 15 15 15 15 15 15 
13 12 12 11 12 13 12 12 10 11 10 09 09 08 08 09 09 09 09 10 10 10 12 13 13 15 17 15 14 15 13 13 15 14 15 16 15 15 15 15 
12 12 10 11 12 12 14 11 09 09 10 10 08 07 10 09 10 10 10 09 11 12 13 13 16 16 17 14 13 13 14 16 14 14 15 15 15 15 14 14 
11 11 12 11 13 13 11 09 07 09 08 09 07 07 10 09 09 10 11 10 12 13 13 14 16 16 15 13 11 14 14 14 14 15 15 16 15 14 14 14 
13 13 12 12 13 11 10 07 07 11 10 07 08 08 08 09 12 11 13 14 14 13 14 12 12 14 15 11 10 15 15 11 13 12 12 15 17 16 17 17 
12 12 12 12 10 10 08 07 05 09 08 07 08 08 08 11 12 14 16 13 14 14 12 12 12 12 12 10 10 13 13 13 12 13 13 17 15 17 17 17 
13 12 12 10 09 09 07 05 04 09 06 09 09 12 13 13 11 16 17 15 13 13 12 11 11 13 09 10 09 15 11 11 13 15 16 16 20 18 19 19 
12 09 09 09 07 07 06 04 04 06 09 07 13 12 13 14 17 16 18 13 12 11 12 11 11 10 12 11 10 10 11 11 15 15 18 19 19 21 20 18 
08 10 08 07 06 06 04 04 03 09 06 11 11 13 13 16 16 18 19 11 11 11 11 11 10 12 09 09 09 11 10 14 16 17 17 18 20 18 19 19 
08 08 08 09 11 10 10 09 10 11 10 12 14 14 15 16 18 20 20 11 13 11 16 15 15 14 19 14 16 17 12 14 12 12 12 14 12 16 13 12 
08 08 09 09 10 10 09 11 11 12 10 13 15 16 16 17 20 20 21 11 12 16 15 17 17 15 15 17 18 18 12 13 12 13 12 14 16 12 12 13 
09 08 10 10 10 09 11 12 14 15 13 14 17 17 18 19 18 22 23 16 13 14 17 19 13 18 15 18 17 17 14 11 12 12 16 14 13 12 12 12 
08 09 08 08 09 12 12 15 15 15 14 16 17 18 19 19 22 23 23 13 16 15 19 19 18 17 21 18 19 17 10 14 12 12 13 12 12 12 11 12 
07 08 08 09 11 11 14 14 14 16 16 17 18 19 20 21 21 24 25 15 14 17 21 21 18 21 18 17 18 19 14 11 12 12 12 12 11 12 10 10 
08 09 11 13 12 13 13 15 16 16 16 18 18 19 19 21 23 25 25 16 16 23 19 19 20 18 14 15 12 11 11 11 10 09 09 10 12 10 10 10 
09 11 11 13 15 14 15 16 17 17 16 19 19 22 23 22 24 25 26 19 19 20 20 19 19 16 16 11 11 11 11 11 09 09 10 10 11 10 10 10 
10 12 16 15 15 14 16 17 19 20 19 16 21 22 23 24 25 27 28 17 24 20 18 13 12 14 11 10 09 09 11 08 09 09 09 12 09 10 09 09 
13 15 15 16 15 17 17 20 19 20 20 22 21 23 25 27 27 29 29 24 18 22 14 14 11 10 09 09 08 10 08 10 09 09 09 08 11 09 09 09 
14 14 16 15 16 16 18 19 21 20 21 21 24 23 26 27 28 28 30 18 24 15 13 12 11 09 08 10 09 08 10 08 09 10 09 12 09 09 10 09 
15 15 14 12 15 14 14 12 11 11 09 12 08 08 09 11 05 12 07 06 17 17 16 16 17 16 18 16 16 17 17 15 16 16 16 14 18 12 13 14 
14 13 14 13 14 13 13 11 11 11 10 09 09 07 07 07 11 06 06 06 16 16 17 16 17 18 16 17 16 16 16 16 16 16 17 14 13 14 14 15 
15 14 10 12 13 13 11 10 10 08 11 11 07 05 13 07 07 06 06 07 16 18 17 16 16 17 18 16 14 17 15 16 16 17 12 16 14 14 12 12 
12 10 13 12 13 10 12 11 10 11 08 10 07 06 06 06 03 06 05 08 16 16 15 16 18 16 17 14 15 14 15 15 16 17 16 13 16 12 13 12 
12 13 12 14 12 12 10 10 10 08 11 07 04 03 05 03 05 07 06 04 16 16 17 17 16 17 15 15 15 15 14 16 18 19 15 17 13 13 13 14 
11 10 13 13 10 09 08 09 07 08 07 05 04 04 04 05 09 05 06 07 16 14 15 15 15 15 16 15 14 15 14 16 13 12 12 13 11 11 09 09 
12 10 11 12 11 09 08 06 05 06 05 05 04 04 05 06 07 07 08 09 15 15 15 14 14 16 15 14 15 15 14 14 12 12 13 12 12 09 09 10 
10 13 13 10 10 08 10 05 04 06 04 03 04 04 05 09 04 08 07 07 14 17 15 15 15 15 14 16 16 14 16 11 12 10 10 11 07 09 10 11 
13 10 10 06 06 07 05 06 04 03 03 03 03 04 07 07 10 07 08 08 16 14 16 15 15 15 16 16 16 15 13 14 11 11 10 09 09 11 10 11 
10 11 07 06 06 05 05 04 03 02 02 03 06 07 07 11 07 08 09 09 13 15 14 15 14 16 15 16 18 13 15 11 11 09 10 09 09 10 11 09 
08 08 06 05 09 07 09 05 06 07 04 04 05 03 02 03 01 06 05 05 14 14 13 14 14 13 16 13 12 12 11 11 09 08 08 08 08 09 08 08 
07 06 07 05 09 09 06 07 07 07 03 06 02 03 01 03 05 05 06 06 14 13 14 14 15 14 14 12 13 13 11 10 08 09 08 08 09 08 08 08 
08 06 05 07 06 08 08 07 06 06 05 02 03 02 05 03 05 06 07 08 13 15 15 16 13 16 13 12 09 09 11 06 08 08 09 09 08 08 08 08 
05 06 06 06 08 07 08 06 07 06 02 04 02 02 03 05 04 07 07 10 16 15 18 17 16 12 14 09 10 09 08 09 08 08 08 08 08 09 08 08 
04 05 06 09 07 08 07 06 07 08 04 02 03 02 05 03 06 09 10 09 14 16 16 16 13 15 10 10 08 10 09 07 09 08 08 08 08 08 07 08 
06 06 08 09 07 07 06 06 04 04 02 07 06 07 08 06 07 08 07 07 15 14 12 10 10 11 10 10 09 09 08 08 07 06 06 08 08 07 06 06 
07 08 07 08 09 05 07 04 05 06 04 06 08 08 08 07 09 07 08 09 12 13 10 09 09 10 09 09 08 08 08 08 06 06 07 07 08 06 07 08 
06 08 11 08 07 06 03 05 06 07 08 07 08 06 06 08 06 08 08 08 13 10 09 08 08 09 12 09 07 06 08 07 07 07 07 08 05 07 07 08 
09 09 07 06 05 05 05 07 06 07 07 10 07 07 06 07 08 08 08 09 09 10 09 08 08 09 07 06 06 07 07 07 08 07 07 07 08 08 08 08 
07 08 06 05 05 05 05 06 06 06 10 07 07 06 07 08 07 09 07 09 10 08 08 08 07 07 07 07 05 07 07 07 07 07 07 08 07 08 08 08 
07 06 05 05 05 05 06 06 07 07 08 07 08 06 07 08 08 09 09 09 09 08 08 07 07 06 06 07 07 07 07 07 07 07 07 08 08 08 08 08 
