38 38 38 32 32 32 31 39 40 40 41 33 36 35 35 40 37 41 32 39 32 41 33 40 40 42 35 45 43 43 42 41 35 41 42 40 44 40 42 43 
32 31 32 32 31 32 32 34 39 39 39 30 35 30 30 30 34 39 39 40 33 33 34 35 34 41 44 43 42 42 42 41 42 42 43 42 40 43 42 42 
32 32 39 32 32 37 30 40 40 30 40 36 30 37 39 30 35 34 40 32 34 34 35 34 44 43 44 42 41 42 41 41 42 43 33 43 45 43 41 41 
38 39 37 30 40 40 38 35 36 36 37 30 38 32 31 38 39 34 43 33 41 41 40 42 44 42 43 35 39 35 42 42 44 45 42 42 43 35 42 42 
32 31 32 37 30 32 34 31 37 39 40 38 38 32 39 41 33 35 34 43 43 40 34 32 32 42 43 40 35 40 41 34 43 42 42 45 44 42 42 42 
32 31 31 31 33 40 30 38 33 41 34 33 33 34 35 33 42 40 41 35 33 35 38 38 39 43 35 42 35 40 40 43 42 42 42 43 43 42 42 42 
37 31 37 38 35 36 38 40 35 30 34 36 34 34 34 40 38 35 43 43 34 36 32 38 38 42 42 41 39 43 41 41 35 42 42 42 35 42 43 43 
31 39 40 35 30 37 33 35 41 34 39 42 40 40 40 33 35 43 43 32 30 31 37 37 40 33 41 38 33 41 42 40 42 35 43 42 42 43 43 44 
38 39 40 35 37 39 34 35 42 35 42 39 34 40 40 34 35 44 43 36 37 36 39 31 38 42 39 34 40 40 34 41 42 42 35 35 42 43 43 44 
34 40 35 40 34 41 34 37 35 41 34 35 42 42 42 43 41 44 44 36 32 37 43 43 43 42 47 43 44 45 34 42 39 41 42 42 44 44 43 43 
40 33 34 41 34 30 31 35 30 31 42 41 42 42 41 42 43 44 45 30 34 42 43 44 45 44 44 45 45 46 35 33 42 42 43 43 44 43 35 41 
40 35 34 34 31 41 36 31 32 38 42 45 42 41 44 42 44 46 48 35 33 44 45 46 42 46 46 46 44 44 41 35 43 43 43 45 44 34 32 31 
35 40 35 40 35 35 35 37 31 34 42 42 42 35 42 45 44 49 48 40 44 42 45 46 47 46 48 45 46 44 42 43 42 44 45 34 42 39 37 30 
35 35 40 34 41 35 30 39 32 39 42 42 41 40 44 43 47 48 50 44 35 45 48 47 45 49 46 45 45 46 43 43 44 43 35 43 32 31 36 40 
40 40 40 39 41 36 39 40 42 43 42 43 44 45 46 46 48 50 51 44 44 51 46 46 46 46 42 44 35 35 41 32 37 35 41 31 38 40 41 41 
40 34 40 40 35 38 39 43 43 43 42 44 46 46 47 47 49 51 53 47 44 48 46 47 47 45 44 41 39 32 33 32 35 41 35 32 41 35 40 34 
40 40 32 41 32 34 44 44 44 45 44 46 47 49 50 50 51 53 53 45 51 42 45 42 35 42 44 33 38 38 31 41 40 35 35 31 41 40 38 38 
33 30 37 38 41 43 44 45 45 45 46 47 50 50 50 51 53 52 54 50 45 50 43 43 40 33 31 40 37 37 30 40 36 35 35 41 41 39 33 32 
36 30 32 34 41 43 44 44 45 46 46 49 49 50 51 52 53 55 55 45 52 42 42 41 40 31 38 31 30 41 40 41 41 40 34 36 39 32 31 32 
31 37 36 40 39 38 38 34 33 39 37 30 29 32 39 30 35 39 40 39 44 43 34 38 38 38 31 31 35 34 32 33 28 28 28 29 28 31 30 36 
30 36 37 30 38 30 30 33 33 34 38 31 33 40 34 34 40 39 34 40 43 42 32 39 37 37 32 34 34 39 36 30 28 29 28 28 36 30 29 29 
38 31 39 41 37 37 37 32 31 29 40 31 34 34 39 32 32 38 36 36 42 38 32 38 38 37 35 33 32 36 31 26 29 29 36 29 39 29 27 27 
41 35 36 36 41 31 40 37 37 34 34 31 35 36 36 38 33 36 29 30 39 34 38 32 30 39 40 39 32 30 28 31 30 36 36 30 28 27 27 28 
30 36 41 37 38 34 37 37 36 39 37 34 35 36 39 40 29 31 28 26 40 32 32 37 33 41 38 38 37 29 31 29 29 28 28 28 28 28 28 27 
41 34 32 31 37 36 29 29 27 35 40 27 28 26 26 29 34 29 31 32 37 38 34 33 33 32 31 29 27 29 28 25 27 27 27 27 36 29 36 31 
36 30 34 33 41 29 29 26 24 37 36 29 26 26 27 30 29 32 37 37 35 35 39 38 38 36 30 27 26 27 27 26 27 26 26 29 28 31 30 36 
33 37 31 32 33 28 29 25 23 39 26 25 27 28 29 33 38 38 30 36 37 34 37 29 28 36 28 25 24 28 24 29 27 28 29 29 39 37 31 37 
38 39 40 29 26 26 25 25 23 24 27 24 28 28 37 31 35 32 32 29 38 33 30 29 27 27 27 26 24 24 26 24 28 28 31 32 32 38 32 31 
33 35 29 26 27 25 24 23 21 25 23 27 36 29 36 41 38 36 38 31 40 36 29 28 27 27 25 24 23 25 23 28 29 36 36 32 32 31 32 38 
37 31 29 29 38 36 39 29 30 37 27 27 28 27 27 28 36 29 29 30 37 29 31 29 29 28 28 27 28 28 26 27 27 28 29 36 39 38 38 32 
30 31 36 29 32 32 29 31 36 36 26 29 27 29 28 29 36 30 37 38 30 36 29 29 28 27 27 28 28 29 25 28 29 31 37 30 33 32 39 33 
37 29 36 31 29 31 39 37 36 30 28 25 29 36 29 31 27 37 37 37 29 37 29 29 27 27 28 29 29 29 28 26 37 38 31 34 36 32 32 33 
29 30 36 37 32 38 38 32 37 29 27 29 36 30 30 29 38 31 38 38 29 28 29 28 27 27 29 29 30 30 28 31 31 39 39 38 35 40 39 32 
36 29 31 33 38 32 31 29 36 37 28 28 31 32 30 38 36 38 38 39 28 28 29 28 26 28 29 36 36 37 30 37 40 33 39 35 38 38 32 32 
30 30 31 29 31 31 29 29 29 29 28 38 30 30 31 30 36 38 31 31 28 31 29 29 29 29 28 29 29 29 30 37 32 38 32 38 38 32 32 39 
36 29 31 29 29 28 30 29 29 29 29 31 31 37 32 31 37 31 30 30 36 29 29 29 30 27 36 29 29 29 37 38 32 38 38 32 38 33 32 32 
36 37 28 28 36 29 27 28 29 29 39 29 37 30 30 36 39 37 36 30 37 29 29 29 29 29 27 29 36 37 31 40 38 38 32 32 34 38 32 38 
37 28 36 28 28 28 28 29 29 36 36 39 36 30 36 36 36 30 36 30 29 32 31 36 28 27 29 37 30 31 37 38 33 32 38 38 32 38 38 32 
30 37 28 28 28 28 28 29 28 29 40 29 36 29 30 30 30 36 29 36 38 29 28 29 28 28 29 30 29 30 32 32 32 33 32 38 38 38 31 32 
28 29 28 28 28 28 29 29 30 30 37 36 31 36 36 36 36 36 30 30 31 30 29 28 28 29 36 30 31 31 32 32 32 32 32 38 32 38 32 38 
