61 60 55 54 60 60 62 62 61 61 54 60 54 54 54 53 53 53 60 55 61 64 63 63 64 54 58 59 63 57 59 57 69 68 68 67 70 68 69 70 
55 55 54 61 55 61 62 61 55 54 53 60 60 53 53 54 53 55 55 56 56 63 64 64 64 59 63 63 58 63 67 67 68 68 69 70 68 70 70 71 
60 61 53 60 61 62 54 61 53 60 60 56 53 52 53 52 53 56 57 62 65 58 59 57 63 61 64 59 67 67 65 71 69 70 67 70 71 71 71 72 
53 54 56 61 60 55 62 53 60 61 60 53 52 52 53 52 60 64 65 57 59 54 63 64 63 57 64 68 68 69 67 68 71 71 69 69 71 72 73 73 
62 62 61 60 64 63 56 55 55 60 53 54 53 54 61 54 63 55 56 62 61 55 54 55 62 55 67 68 70 58 66 72 72 72 72 73 69 71 68 68 
61 61 62 62 53 57 61 55 60 54 52 53 55 62 63 58 65 57 58 55 55 60 56 63 58 57 68 71 74 68 68 72 72 72 73 69 71 68 68 68 
63 61 53 54 54 61 58 55 55 53 53 60 63 64 59 65 64 59 66 54 60 55 64 67 68 69 68 74 75 68 74 70 71 68 67 69 68 67 68 68 
54 60 60 60 55 56 61 56 55 53 61 62 64 59 61 58 58 59 66 54 56 64 68 68 69 71 76 75 77 75 70 74 68 68 67 67 66 69 67 68 
53 54 53 55 60 55 61 54 61 55 55 57 59 62 56 57 65 67 67 57 63 66 67 70 71 75 74 77 78 70 76 68 69 68 67 66 67 68 67 66 
60 60 54 56 57 62 54 63 58 59 57 65 55 63 58 59 70 70 71 64 66 59 70 69 69 69 72 71 72 73 68 69 66 67 67 67 68 67 65 64 
60 61 55 64 64 62 64 65 55 62 65 60 64 66 67 67 70 71 73 58 66 69 69 70 70 71 71 73 72 72 68 66 67 67 67 66 67 64 63 63 
61 61 59 65 56 65 56 61 61 55 61 58 67 69 67 71 70 73 73 68 67 70 71 72 69 72 75 72 72 72 67 67 68 68 67 68 66 62 60 60 
62 65 58 60 59 64 56 55 56 62 59 66 69 70 72 72 75 74 74 68 69 69 71 72 74 73 74 74 72 70 67 68 68 68 68 57 59 56 60 64 
64 63 54 61 65 62 54 62 63 64 65 68 70 71 71 75 73 74 74 70 68 71 73 73 73 74 72 70 70 70 68 67 68 68 62 66 61 65 59 62 
59 59 59 61 54 55 55 57 63 64 67 67 71 71 71 73 75 74 74 69 70 76 72 70 70 72 68 67 63 56 59 63 55 58 58 60 54 63 62 56 
65 54 59 60 57 56 57 64 65 66 69 70 71 71 72 74 75 75 77 72 70 74 70 71 71 69 69 56 62 62 57 62 58 58 64 59 57 62 61 61 
59 59 64 63 56 56 55 65 66 67 68 71 72 73 74 75 73 78 79 71 77 67 68 59 58 67 55 55 65 65 61 58 63 63 63 64 65 55 53 52 
54 55 62 64 57 64 65 59 67 69 71 71 74 74 75 75 78 78 79 76 68 74 66 59 63 55 54 58 58 60 63 58 65 57 56 62 62 53 53 52 
54 55 58 63 64 64 59 68 68 70 70 73 74 73 75 77 77 80 79 69 76 65 65 58 56 61 64 54 59 63 58 57 63 62 61 62 54 53 52 52 
62 56 60 65 57 61 59 64 64 58 58 54 59 65 54 62 54 64 61 61 67 67 58 57 63 57 56 63 61 61 60 58 58 55 60 53 51 50 49 49 
55 55 61 65 61 54 63 58 57 59 58 65 54 54 60 55 58 61 65 59 58 65 57 57 62 56 57 61 61 65 63 64 60 53 52 51 51 49 51 52 
62 60 65 65 65 63 55 58 65 58 54 62 54 65 58 56 63 65 58 58 66 62 63 62 63 56 56 60 65 60 64 56 53 51 53 50 48 51 52 53 
59 64 63 57 63 58 63 55 54 61 60 61 65 65 55 60 64 65 63 64 58 58 63 57 62 54 54 65 65 57 53 53 53 51 49 50 50 52 53 61 
58 57 56 57 62 56 54 58 61 54 61 59 59 58 54 64 64 58 56 61 64 56 57 56 54 60 65 54 54 53 60 52 51 49 49 49 51 54 60 61 
63 63 61 55 64 58 63 59 63 54 65 65 64 56 56 63 59 62 63 63 62 55 59 58 58 65 60 54 60 52 51 61 52 53 53 51 52 61 61 61 
65 60 59 59 61 58 65 63 63 59 58 64 56 56 62 57 63 57 55 55 55 54 58 58 65 60 59 60 65 53 52 52 53 60 60 53 54 55 61 55 
57 61 55 65 55 64 58 63 58 59 58 57 62 60 54 58 58 61 53 52 60 57 58 58 65 54 57 59 59 51 54 53 54 53 53 53 57 56 55 55 
62 60 55 65 58 59 63 60 64 64 62 56 54 60 55 62 56 53 53 52 59 59 59 65 65 60 60 55 59 55 60 56 53 60 53 61 54 60 61 57 
54 56 64 64 58 63 58 58 64 56 56 54 55 60 55 57 54 53 51 53 65 58 59 65 59 54 60 64 59 53 56 53 53 53 60 60 61 62 55 56 
65 64 64 56 61 61 63 61 55 61 61 60 57 57 64 62 61 56 58 65 65 63 58 64 64 63 58 56 62 56 53 54 53 54 60 60 56 56 61 61 
58 62 56 62 56 54 62 61 55 55 63 56 64 58 65 64 62 59 58 64 58 64 64 63 64 58 56 62 62 62 54 53 60 55 61 55 56 61 55 56 
63 57 61 56 61 57 60 55 53 53 60 59 59 54 55 59 61 64 63 63 57 65 57 63 62 63 58 56 61 55 54 60 56 62 61 57 62 55 53 53 
56 61 57 63 63 53 63 54 60 53 65 62 65 60 61 65 55 60 59 61 64 56 63 57 63 61 56 61 61 61 60 55 55 62 63 54 62 53 53 54 
63 63 57 58 54 63 60 54 52 53 55 59 61 61 65 56 65 62 58 57 56 57 63 63 60 62 55 61 55 62 55 61 57 62 60 56 53 54 53 53 
62 61 53 61 54 53 60 52 52 53 64 59 64 63 57 58 56 55 53 53 56 58 55 55 55 61 60 55 53 53 60 53 53 52 52 53 60 53 53 60 
60 61 53 60 54 54 53 53 60 54 63 59 63 63 63 63 56 53 53 60 55 56 61 55 55 53 55 53 53 53 52 53 52 52 53 53 53 54 53 53 
55 53 57 55 52 60 51 53 60 54 59 56 56 61 61 61 52 53 53 53 58 60 61 53 52 54 60 53 53 53 53 51 52 52 52 60 54 53 53 54 
53 60 52 53 53 52 60 54 54 61 56 64 63 56 60 60 53 53 53 54 60 56 52 53 53 53 53 54 53 53 52 52 52 52 53 53 54 55 54 53 
52 51 60 53 52 54 53 54 55 55 59 56 61 53 54 53 52 60 53 53 57 53 54 52 53 53 53 53 52 52 52 51 53 53 53 60 60 53 60 54 
53 52 53 53 53 60 54 55 61 62 63 56 61 53 53 53 53 53 60 54 60 53 60 53 53 53 53 52 52 52 52 52 53 53 53 54 60 54 53 60 
