73 73 72 73 73 72 77 74 76 77 77 76 76 74 74 74 73 72 70 70 69 66 68 67 67 64 69 55 58 59 66 59 67 59 65 65 59 59 64 64 
72 74 72 74 75 73 74 77 77 76 76 77 74 74 73 73 73 70 70 68 68 67 67 67 68 65 57 59 66 59 67 67 59 59 59 64 65 58 59 66 
73 72 74 75 72 77 77 77 75 77 76 75 74 72 74 73 70 70 69 69 66 70 68 68 62 66 64 67 67 67 66 67 66 66 65 59 58 59 65 65 
73 73 74 78 74 76 77 75 76 76 75 75 72 72 72 71 71 69 68 69 68 66 69 69 63 66 67 67 70 67 66 66 66 59 58 59 66 65 66 66 
72 74 72 75 82 80 78 76 76 75 74 77 73 72 72 71 68 68 65 63 65 59 67 66 66 71 68 70 70 59 65 69 66 65 59 66 64 59 63 56 
72 74 77 75 76 78 77 76 76 76 74 74 72 71 71 69 68 64 56 64 64 68 66 67 68 69 69 70 69 67 65 67 59 66 66 64 65 56 56 62 
77 75 78 78 74 77 75 76 77 73 76 73 70 66 59 67 68 56 61 67 67 58 67 68 69 68 72 70 71 65 69 57 65 63 56 64 57 62 55 55 
75 76 74 76 77 76 76 77 77 76 71 73 66 66 64 64 56 57 54 66 59 68 69 68 69 69 68 71 71 69 63 68 63 57 62 56 62 56 55 61 
75 74 76 77 75 75 76 78 78 72 74 67 66 65 58 57 62 54 58 67 68 67 69 69 68 67 71 71 72 65 69 63 63 56 56 56 61 61 61 54 
75 74 73 69 72 71 67 68 65 58 68 66 58 61 60 59 54 54 52 66 57 65 65 54 55 55 57 63 62 62 64 63 65 64 64 57 55 60 61 56 
74 72 72 69 69 68 68 64 63 57 66 65 54 57 57 63 55 52 50 65 63 54 55 56 62 62 63 62 61 55 63 65 58 56 56 56 60 62 57 63 
73 72 66 66 71 66 66 63 57 63 59 64 57 60 58 53 53 51 52 54 56 56 57 61 62 57 64 60 63 57 57 66 62 54 56 54 60 64 66 67 
70 66 68 59 65 57 62 63 56 63 60 58 55 53 51 53 49 53 51 63 56 64 61 63 58 56 61 63 57 57 63 61 55 54 59 61 62 65 67 69 
68 69 64 59 56 62 63 57 61 55 65 55 53 50 51 49 51 51 51 56 58 56 62 62 54 62 64 58 56 62 55 61 54 65 56 61 59 67 68 71 
66 59 67 65 56 55 56 60 64 63 55 64 54 60 55 51 50 51 50 56 55 53 62 60 53 64 62 63 59 60 55 66 57 58 65 64 65 70 69 69 
66 59 64 63 57 65 55 57 58 58 57 54 55 53 52 51 50 50 48 63 57 62 53 60 54 59 58 54 56 63 56 64 59 67 68 64 69 69 71 72 
58 66 64 61 62 55 57 57 61 60 62 57 53 51 50 50 53 48 46 55 52 53 55 57 64 61 59 57 63 63 66 65 67 67 68 67 69 71 72 73 
66 62 63 65 57 57 64 60 55 55 61 61 53 51 48 48 47 46 45 50 60 50 55 62 61 61 64 57 58 58 66 70 68 69 68 70 70 71 72 75 
55 64 64 57 57 65 55 62 53 55 56 52 49 49 48 48 47 46 44 51 48 61 59 65 59 64 56 63 59 66 70 68 68 68 70 69 71 74 75 75 
55 60 56 62 65 55 60 58 56 62 62 59 57 63 63 54 67 59 63 64 54 61 57 64 65 65 63 57 66 67 69 69 73 73 73 73 77 77 78 78 
55 56 54 56 59 60 64 62 57 54 63 56 63 63 59 63 60 58 65 66 62 62 65 54 61 62 62 67 68 68 70 72 73 75 75 75 76 78 78 79 
54 56 57 55 57 62 61 62 56 63 60 58 65 67 58 65 58 66 59 65 62 57 61 57 60 58 68 69 70 71 71 71 75 77 74 78 79 79 77 77 
62 55 62 62 56 61 62 62 62 54 57 56 67 67 66 59 69 59 67 59 64 54 63 64 66 68 69 70 71 71 73 74 77 78 79 78 80 77 78 78 
62 62 55 54 55 56 61 57 62 62 54 66 68 69 59 70 66 65 66 70 65 56 64 65 69 69 70 70 72 74 73 76 79 78 79 80 78 78 78 79 
55 61 65 55 55 61 64 57 64 63 63 59 64 64 58 67 64 66 59 65 56 56 66 66 66 70 71 75 76 74 75 80 77 76 76 78 76 78 75 75 
54 61 54 54 62 62 57 59 66 58 62 59 64 65 66 65 67 65 66 67 62 59 66 69 70 71 73 77 78 77 76 79 76 77 78 76 77 75 74 74 
61 65 58 63 55 64 66 66 65 58 66 62 65 59 65 59 63 67 69 70 58 64 69 72 73 73 79 79 80 76 81 73 76 75 75 76 78 75 74 74 
65 62 60 57 64 59 67 65 66 65 64 66 65 65 66 59 65 70 69 71 68 68 72 73 75 77 77 79 81 80 74 81 76 76 74 74 73 74 73 74 
59 59 57 57 58 67 66 66 67 57 66 64 66 59 66 64 67 70 71 70 67 70 73 73 76 76 80 81 83 76 82 75 75 74 74 73 74 74 74 73 
61 56 61 55 68 67 65 64 59 59 63 66 63 63 64 66 58 67 64 58 69 70 71 72 73 73 76 74 73 73 76 75 75 73 73 73 70 72 72 72 
55 62 58 58 66 66 64 65 65 59 63 58 64 58 64 57 68 58 65 66 69 70 73 73 74 73 76 73 74 75 75 75 73 72 71 71 71 72 72 72 
58 63 55 63 66 64 66 66 66 67 59 58 64 57 68 66 57 64 59 66 70 75 74 75 74 76 71 73 72 72 75 74 72 70 73 70 73 72 73 74 
62 63 62 57 64 59 65 67 67 67 63 66 64 64 58 64 58 66 65 66 73 74 76 76 75 73 75 72 72 72 72 72 71 70 70 72 70 73 73 75 
61 62 56 58 66 64 66 66 67 68 66 64 58 58 64 64 64 66 59 64 73 75 75 77 73 76 71 73 72 72 72 71 70 69 71 69 73 74 74 75 
56 62 69 67 65 66 64 66 64 64 64 56 62 62 56 64 67 66 67 67 73 72 72 71 71 72 73 72 73 74 71 73 71 71 72 72 72 74 74 74 
65 64 67 68 67 66 66 64 64 58 63 63 56 57 58 66 66 67 67 68 72 72 71 71 71 74 72 74 72 72 71 72 72 72 73 71 74 74 74 75 
63 69 59 58 69 59 59 58 63 63 56 54 63 59 66 67 67 68 68 68 72 70 71 71 71 73 75 73 71 71 73 70 72 72 72 73 74 75 75 76 
70 65 69 64 56 62 56 56 62 64 56 63 66 66 67 67 69 69 69 68 69 70 70 70 72 73 73 72 72 71 71 74 73 73 72 73 74 76 75 76 
66 71 63 56 57 62 56 58 57 63 56 58 66 67 67 69 68 68 67 69 70 70 71 71 71 73 72 71 72 72 74 72 72 73 73 74 74 75 74 75 
59 66 63 56 62 56 56 63 63 63 64 66 66 67 68 69 69 69 68 69 70 70 71 72 72 72 72 72 71 72 73 73 73 72 73 74 75 75 76 76 
