34 40 33 35 41 40 43 41 43 44 46 44 48 47 47 46 49 46 49 50 49 52 48 50 51 53 52 56 51 50 48 46 43 35 35 33 40 38 33 40 
33 39 34 35 42 42 35 44 45 44 45 48 47 47 48 46 47 50 51 51 50 49 51 51 51 53 56 50 49 48 46 44 35 41 34 34 32 34 40 40 
40 33 43 43 40 43 44 46 46 48 46 47 48 49 46 48 48 51 52 48 51 51 52 52 56 55 51 48 45 46 44 42 41 39 32 32 43 41 35 42 
35 41 41 44 42 42 45 47 49 47 46 47 50 50 47 49 51 53 55 49 50 52 52 53 53 52 52 45 35 44 42 35 33 33 40 34 33 42 43 44 
33 40 40 42 46 47 47 50 51 44 45 52 51 52 52 52 50 54 52 55 54 49 50 45 44 50 51 43 42 43 42 39 34 35 42 34 42 45 46 47 
39 42 43 45 46 48 49 52 52 48 48 51 52 53 54 53 53 52 52 52 49 51 44 44 45 49 45 42 40 41 42 39 42 41 41 42 43 47 48 49 
42 42 45 47 47 48 52 53 55 47 53 51 53 52 52 52 55 53 54 54 48 45 44 44 44 47 44 34 38 41 38 44 43 44 45 44 48 50 51 52 
42 47 46 50 51 53 52 55 56 54 53 56 53 53 51 53 51 54 53 46 44 42 44 42 44 35 43 40 39 32 43 34 45 45 46 48 49 51 52 53 
46 45 49 50 51 51 55 56 58 53 57 52 52 53 53 51 53 54 53 42 42 42 44 41 35 44 40 31 37 40 32 44 44 46 47 48 51 51 53 54 
47 45 48 47 42 44 47 49 48 48 53 53 55 57 58 57 62 58 61 43 46 42 52 50 50 48 53 48 51 53 35 45 43 46 47 49 50 52 49 48 
47 45 45 48 44 46 50 48 49 50 54 54 58 58 60 58 58 62 62 42 48 49 50 50 51 51 47 53 53 53 43 42 47 47 48 50 53 48 48 48 
44 47 47 47 47 49 46 49 49 49 54 60 60 63 56 61 60 63 62 50 46 53 52 53 46 51 55 54 53 53 45 48 49 49 51 52 49 47 44 43 
47 48 50 50 49 47 50 48 48 50 59 58 64 63 62 60 65 62 63 46 49 47 52 52 53 53 56 54 55 53 49 50 51 51 51 47 48 44 43 43 
49 50 49 48 49 50 47 50 49 49 57 62 62 63 62 65 62 62 63 48 45 52 55 54 53 56 55 53 56 57 49 50 49 51 48 49 44 44 35 40 
49 48 43 45 48 48 52 50 53 55 59 58 61 60 60 62 62 63 63 49 50 60 56 56 57 54 48 53 48 47 48 43 45 43 43 44 47 42 42 43 
46 47 45 46 47 51 50 55 56 56 59 60 60 60 61 62 63 63 65 54 55 57 57 56 56 51 52 47 45 45 45 44 43 35 35 44 43 43 42 42 
48 43 48 50 47 52 53 56 57 58 59 62 61 62 63 63 61 65 67 51 61 58 55 50 48 48 50 45 44 44 42 46 42 43 43 45 45 43 35 34 
43 49 45 50 54 56 58 59 59 58 61 60 64 63 63 63 65 67 68 63 56 61 52 51 45 45 42 44 43 45 43 40 44 42 43 43 45 42 42 39 
48 43 51 53 54 57 57 57 59 60 59 62 62 63 63 64 66 68 70 56 64 52 49 47 46 42 44 45 42 42 33 43 42 42 42 45 42 40 35 41 
48 48 48 48 50 49 48 48 45 45 43 47 40 35 42 45 35 48 42 35 55 53 51 49 48 47 46 46 47 48 49 46 48 46 45 43 48 42 43 44 
48 49 49 47 49 47 48 45 45 46 42 42 42 42 41 43 48 35 42 42 53 52 48 48 47 47 45 48 47 47 47 49 45 47 46 45 44 44 44 45 
49 48 48 48 49 47 46 44 43 41 45 39 42 34 49 45 35 34 34 34 52 50 48 46 46 45 50 48 49 50 47 44 47 48 42 46 43 44 43 43 
48 47 47 46 46 45 44 44 43 45 40 46 41 42 43 34 39 40 32 35 48 47 46 45 46 48 46 49 49 45 47 46 48 48 46 44 47 44 44 43 
46 47 46 47 45 44 43 44 42 42 47 41 41 41 35 33 32 41 32 30 48 46 46 45 48 45 49 49 50 45 45 47 50 49 44 48 43 43 43 44 
46 45 49 47 44 43 42 35 32 42 41 37 38 30 36 38 43 33 40 35 47 47 46 47 47 48 48 51 51 47 46 51 46 46 46 44 34 40 31 36 
47 47 46 44 44 42 42 38 31 33 38 32 36 31 37 34 33 35 41 42 46 47 47 48 48 49 50 51 52 49 47 47 46 44 44 40 42 30 30 36 
45 48 45 42 44 41 39 37 41 34 30 32 32 39 40 42 41 35 40 34 47 45 48 48 48 49 52 53 53 45 50 48 44 34 39 34 41 35 34 40 
48 43 45 35 38 37 37 35 40 41 32 35 34 39 35 42 45 42 42 33 46 48 47 48 50 50 51 53 53 51 46 48 42 34 36 36 34 40 33 35 
42 47 34 38 38 31 41 35 33 36 34 38 39 34 34 45 41 40 35 35 48 47 49 49 50 51 52 54 54 47 50 42 33 38 36 34 33 41 40 38 
42 43 34 42 46 43 46 35 43 44 37 38 33 39 33 33 33 39 31 31 45 46 40 32 38 33 40 34 36 35 43 35 32 41 34 39 37 31 31 31 
35 43 43 43 46 44 35 44 43 43 32 39 33 33 39 39 34 31 32 33 43 43 38 38 36 37 39 41 40 34 34 34 40 34 38 31 37 31 30 36 
44 35 44 45 41 44 45 43 42 42 32 39 39 39 40 40 35 32 36 30 44 36 36 33 41 35 38 40 34 34 40 39 33 31 33 30 32 37 31 37 
41 43 42 44 45 44 45 43 43 42 37 39 39 33 32 35 32 41 30 32 30 39 33 39 34 35 37 34 32 35 34 34 32 37 30 31 29 37 37 32 
43 41 44 46 45 45 43 42 42 44 33 33 33 39 36 38 35 32 31 38 35 33 34 38 39 30 39 40 33 31 41 37 32 36 31 29 31 37 37 32 
43 43 46 44 44 44 34 42 34 33 37 41 32 39 39 36 36 37 36 30 35 34 33 33 33 38 41 38 37 31 32 40 37 31 32 30 36 31 29 29 
44 42 45 45 43 35 42 39 32 38 33 32 39 32 32 37 31 30 41 35 40 39 33 38 38 38 33 31 38 33 33 32 32 30 30 29 37 29 30 37 
43 46 43 41 43 34 34 32 38 38 40 42 32 36 35 36 39 35 41 41 33 39 32 38 38 41 30 32 36 30 33 39 31 29 29 31 28 36 29 29 
46 35 44 40 38 32 31 32 31 33 38 34 30 30 41 30 35 31 41 39 38 32 39 32 31 37 40 29 30 37 31 32 37 36 28 28 30 28 29 37 
42 45 39 32 38 31 37 39 32 31 35 37 30 41 30 35 36 34 39 38 38 32 37 30 37 35 30 31 29 31 39 36 29 28 28 30 28 37 36 37 
35 41 32 31 37 31 31 37 38 38 32 36 37 35 41 41 41 39 38 32 38 38 31 37 37 38 30 32 31 31 37 30 29 28 28 29 29 31 37 37 
