18 18 18 16 18 18 16 17 14 14 12 15 09 10 11 12 11 13 10 09 09 07 09 07 07 06 06 05 07 08 09 10 13 12 12 13 11 15 13 13 
18 16 18 15 17 17 17 14 12 14 11 11 11 11 11 11 14 09 09 08 08 09 07 06 06 07 05 08 08 09 09 12 12 12 11 13 14 13 13 14 
18 18 14 15 18 16 17 13 11 10 13 09 11 09 14 12 08 08 07 10 08 08 06 05 05 05 08 10 11 11 12 12 12 12 15 13 14 14 15 15 
16 16 17 15 17 16 13 11 09 09 11 12 09 10 11 11 11 07 05 09 08 07 05 05 06 07 07 12 14 11 11 13 12 11 14 15 14 15 15 15 
18 17 18 14 14 12 11 09 07 16 14 08 10 08 07 09 12 07 09 06 05 09 06 07 08 08 09 14 14 13 12 17 13 13 14 12 12 14 12 12 
18 14 16 14 10 11 10 07 05 12 12 09 07 05 05 10 08 10 09 07 05 07 08 10 11 11 13 14 16 15 13 14 14 14 14 12 14 12 12 13 
16 17 10 09 11 10 10 05 03 13 06 11 07 08 08 10 10 09 08 05 09 06 11 11 11 12 16 17 19 12 17 14 14 12 12 13 13 12 12 12 
15 10 12 08 07 07 05 03 02 06 09 03 08 07 09 09 11 10 10 09 08 12 11 12 12 14 16 20 19 17 14 17 14 13 11 12 12 12 11 12 
10 13 07 07 06 06 04 03 00 07 02 08 08 09 07 11 10 08 09 08 12 10 12 13 14 15 18 19 19 15 18 13 12 11 12 12 11 12 11 11 
09 10 08 10 13 11 14 10 11 12 07 07 07 06 06 06 03 07 05 10 08 11 07 08 09 10 12 12 11 11 14 13 16 17 18 16 21 15 18 19 
08 11 10 11 13 11 10 12 11 11 07 07 06 05 04 06 06 05 03 10 07 08 09 10 10 09 13 11 12 12 16 15 18 17 19 17 16 19 19 19 
11 09 12 13 10 13 12 11 10 10 07 07 04 03 07 04 09 04 04 07 09 07 10 11 11 13 10 11 11 11 13 20 19 21 14 19 18 19 18 18 
09 13 11 13 13 11 13 11 11 10 04 05 04 03 04 06 02 05 04 09 09 12 11 12 12 10 13 11 11 11 18 16 22 21 20 19 22 19 20 18 
11 10 13 14 11 14 11 10 11 11 06 04 03 02 04 02 05 04 03 09 12 10 12 14 12 13 10 11 11 10 15 20 20 22 20 22 19 18 20 21 
12 11 15 15 11 11 08 09 07 07 04 06 05 05 05 04 04 03 02 10 10 05 09 08 08 10 14 11 13 14 18 19 19 19 19 20 18 20 19 19 
13 13 13 13 13 09 09 07 05 05 05 05 05 04 04 03 04 02 02 07 07 08 08 08 08 12 12 14 15 16 20 19 19 19 20 19 19 19 19 19 
11 14 15 11 11 08 09 06 04 04 06 07 04 02 02 04 03 02 00 10 05 09 09 11 12 13 11 15 16 17 19 20 20 20 21 18 22 20 20 21 
15 11 12 09 06 07 04 04 04 05 04 06 03 03 01 02 02 00 00 04 08 05 11 11 14 14 17 17 18 17 20 20 22 21 20 21 18 21 20 21 
12 13 09 06 06 04 05 05 04 04 06 04 02 03 02 02 00 01 00 08 04 10 12 12 13 17 16 17 18 19 20 20 20 21 20 17 20 20 20 21 
10 09 11 09 09 10 08 11 11 11 12 10 15 13 12 11 11 09 11 12 08 09 09 09 09 10 12 15 16 17 18 18 19 18 18 19 19 21 21 21 
10 09 10 09 08 08 11 11 12 10 13 14 12 11 11 10 09 12 13 14 08 10 09 11 10 13 13 17 17 17 16 19 18 19 18 19 20 21 21 22 
09 10 07 07 11 09 11 12 13 14 11 15 11 12 10 10 09 14 15 16 10 07 11 13 12 14 19 18 17 19 19 16 18 18 20 20 21 22 22 22 
10 08 10 09 09 10 10 12 13 11 13 10 13 11 09 12 13 15 17 18 10 12 14 14 15 18 16 16 17 18 18 18 18 18 20 20 21 22 22 23 
09 10 07 08 10 09 12 14 15 11 09 12 11 12 11 12 15 17 17 20 12 12 13 14 17 16 17 18 19 18 18 17 19 19 19 20 21 23 23 23 
08 08 08 09 10 11 14 17 19 11 11 18 15 16 16 15 13 18 15 15 12 13 14 14 14 17 18 19 20 18 18 21 19 20 20 21 21 22 21 21 
08 09 09 11 13 14 15 20 20 14 14 15 16 17 17 14 17 15 16 17 13 15 14 16 17 18 19 21 21 19 19 20 20 22 23 21 22 21 22 23 
09 09 11 13 15 16 20 21 22 12 18 17 17 14 14 15 15 16 16 17 14 12 16 17 17 19 21 21 22 19 22 18 21 21 21 22 22 23 23 24 
09 12 13 15 18 20 21 24 23 19 15 20 15 15 13 14 14 15 16 19 14 16 16 17 19 20 21 22 22 21 20 23 21 22 22 23 23 24 23 24 
11 12 15 17 19 20 22 22 24 16 21 15 14 13 15 14 15 18 18 18 15 15 18 17 19 20 21 22 23 21 23 21 22 23 23 23 22 23 23 23 
13 13 13 13 15 15 13 15 15 15 15 16 17 18 19 19 22 20 20 20 15 16 18 18 19 19 19 19 19 19 21 21 21 19 19 20 18 22 22 22 
13 13 14 14 14 16 14 15 14 14 17 15 19 19 20 21 20 20 20 20 16 17 19 18 19 18 20 19 20 21 19 21 19 19 18 19 21 22 21 21 
14 14 14 13 15 13 17 15 16 17 16 22 21 22 19 22 20 20 18 17 17 20 18 18 20 19 17 20 20 20 21 20 19 17 21 19 25 22 22 22 
14 13 12 11 13 14 13 18 16 16 20 19 22 22 22 19 22 18 18 17 18 18 20 19 18 18 19 18 20 22 20 19 16 17 20 22 19 21 22 24 
13 12 11 12 13 12 16 15 16 16 18 22 21 22 20 23 18 18 18 18 18 19 18 18 17 19 19 22 21 22 20 17 18 17 21 18 22 23 22 24 
12 12 15 15 14 14 15 17 17 17 19 17 18 18 18 18 19 18 18 18 18 20 20 21 22 19 20 22 22 22 19 21 21 22 23 22 23 23 23 24 
13 14 14 15 16 16 16 17 16 16 18 18 18 16 16 18 18 18 18 19 20 19 22 21 21 21 21 22 22 23 22 21 23 23 23 21 24 24 25 25 
13 15 16 15 16 15 20 17 16 16 16 20 17 18 18 19 19 19 19 19 20 24 22 21 21 21 25 23 22 22 22 24 23 23 23 24 22 25 26 26 
16 15 16 16 14 16 15 15 15 17 18 15 18 17 19 19 19 18 19 20 21 21 21 21 21 23 22 22 22 23 24 24 24 24 23 24 25 27 26 26 
14 16 15 14 15 15 16 16 15 16 15 17 18 17 18 19 19 19 20 20 21 21 21 20 22 22 22 23 23 23 24 24 23 24 24 25 25 26 25 26 
15 15 15 14 15 15 15 16 17 17 16 17 17 19 19 19 19 20 20 21 21 21 22 21 22 22 22 23 23 24 24 24 24 23 24 25 26 26 26 27 
