43 43 42 41 43 42 44 41 34 34 32 35 35 41 30 38 35 40 35 40 34 36 33 32 32 29 34 25 29 36 30 38 31 38 39 35 40 37 40 40 
42 43 42 43 43 42 43 40 34 40 31 37 30 30 41 36 40 34 33 32 38 38 32 38 39 29 27 30 31 31 31 37 33 39 33 35 37 40 40 41 
43 42 35 42 42 44 39 34 32 37 39 34 36 40 40 37 41 38 36 34 36 33 39 40 26 31 29 32 30 30 32 38 33 39 37 30 35 40 38 38 
42 42 43 43 34 42 42 38 31 41 37 32 34 40 31 36 34 30 27 33 38 37 35 35 27 29 38 30 33 37 32 34 34 41 36 40 35 38 30 36 
42 43 43 42 46 43 40 36 34 42 40 41 33 30 30 38 34 29 29 27 29 32 35 40 40 30 37 38 30 41 35 34 40 32 32 40 35 38 38 38 
42 42 44 42 39 40 38 33 32 38 41 34 30 29 29 38 30 36 28 29 37 34 34 34 40 39 33 29 36 34 33 41 38 32 39 34 32 38 36 36 
44 44 42 34 31 32 39 31 36 32 33 30 29 29 29 32 33 29 27 38 34 36 39 32 38 31 29 30 36 35 34 30 37 31 32 33 33 37 29 29 
43 32 38 35 40 38 38 37 36 31 36 28 28 28 36 37 30 29 27 35 40 34 40 38 31 36 28 29 30 38 38 32 38 31 38 38 31 36 29 28 
38 39 41 35 38 39 30 30 29 28 28 28 29 28 28 31 28 25 24 33 41 39 38 37 36 27 29 32 30 30 32 30 38 30 37 32 30 29 27 28 
36 36 40 34 33 30 33 37 31 37 28 27 26 24 24 24 22 23 21 33 29 38 24 27 28 28 29 29 27 27 38 30 40 39 39 31 30 37 41 30 
41 30 30 41 36 41 31 31 29 29 28 27 24 24 23 24 23 21 19 32 29 26 28 28 28 28 30 27 27 28 38 40 33 34 34 39 38 30 38 33 
37 40 41 34 34 31 35 36 29 29 27 25 23 22 24 22 24 20 19 26 29 27 28 26 29 29 26 26 25 25 37 30 40 36 36 35 39 39 40 35 
34 33 30 29 37 37 28 30 29 29 23 24 23 22 22 20 19 21 19 29 27 36 26 28 28 25 27 26 25 25 33 38 35 30 41 31 35 41 43 42 
32 36 36 37 28 28 30 29 29 29 24 22 22 21 20 19 20 18 18 28 30 27 27 27 26 28 25 26 24 24 31 34 32 30 32 41 40 35 43 46 
31 30 36 35 29 29 26 28 25 24 22 24 20 20 20 18 17 15 13 28 27 17 21 20 20 24 30 27 37 39 34 33 34 41 42 35 38 44 43 43 
39 38 32 31 38 27 28 24 22 22 22 21 20 19 19 15 16 13 12 22 22 21 20 20 21 27 27 39 40 35 33 33 42 42 42 42 42 43 43 44 
36 30 40 29 31 26 26 22 21 21 23 20 18 16 15 16 14 11 10 26 16 20 22 26 28 36 37 35 36 30 40 44 43 41 35 40 44 44 45 46 
37 31 39 26 23 22 21 21 20 21 19 21 18 16 13 14 12 11 10 15 22 16 25 26 37 32 31 36 38 37 42 43 35 42 42 43 41 44 45 48 
31 41 26 23 23 21 21 21 20 18 22 17 15 14 13 13 11 10 10 19 14 24 28 30 36 30 30 30 38 35 43 42 42 41 43 40 44 47 46 47 
29 28 31 38 27 29 28 40 31 30 28 27 26 27 27 25 36 24 26 27 22 24 27 28 29 36 39 33 39 40 39 37 40 34 35 38 36 43 40 40 
36 36 29 30 27 29 33 30 29 28 27 26 27 27 28 27 25 27 28 29 25 26 29 30 37 36 39 40 40 41 35 35 41 36 35 38 42 34 41 35 
28 36 39 36 32 37 32 28 26 27 26 29 29 29 24 28 27 29 29 30 25 37 31 38 31 40 39 40 39 39 37 33 36 36 42 40 34 40 40 35 
37 31 37 30 31 29 27 25 24 26 27 27 29 36 29 28 38 37 31 29 29 30 32 33 34 33 35 39 33 31 41 33 30 37 39 33 32 40 33 42 
29 31 30 28 29 27 26 27 24 27 26 29 30 38 29 38 30 29 37 32 29 38 33 40 33 35 39 39 40 37 33 30 30 31 32 38 33 41 34 33 
36 29 27 26 27 25 28 23 23 27 27 23 27 27 27 29 31 37 39 34 36 38 31 37 37 39 39 34 40 36 30 40 36 36 36 38 43 34 41 42 
28 27 27 25 24 25 25 23 23 25 26 26 27 27 28 37 31 40 36 31 37 38 31 32 39 41 39 40 39 35 41 36 36 37 32 40 35 42 44 45 
28 26 26 25 23 26 22 22 21 28 24 27 28 36 37 37 38 31 33 34 33 28 38 38 39 33 31 34 40 37 41 35 32 40 35 43 40 44 44 44 
26 23 23 23 23 22 25 22 22 23 28 25 28 36 34 34 31 40 41 41 31 34 33 33 39 39 39 35 40 34 36 37 35 41 42 43 46 44 45 45 
24 23 23 23 22 26 22 21 20 26 23 29 38 39 34 30 38 40 43 43 34 37 39 34 33 39 34 33 39 30 36 39 35 42 42 46 43 45 46 47 
22 25 23 24 35 33 30 29 30 37 27 31 37 40 35 31 37 35 39 39 39 39 35 40 40 40 35 31 39 40 38 39 35 35 41 42 43 44 44 44 
22 24 29 27 38 31 28 37 37 32 36 36 35 35 36 31 35 33 39 33 38 41 34 41 34 31 30 40 40 34 38 41 35 42 42 41 45 44 46 47 
28 26 25 27 37 28 38 39 30 37 38 31 30 37 40 34 38 32 38 32 40 37 34 35 41 36 41 41 42 43 35 41 42 43 44 44 42 46 46 46 
25 25 25 25 28 39 31 31 31 32 30 31 39 39 39 31 32 38 37 32 32 34 35 41 37 34 40 43 43 43 41 43 44 44 44 44 45 44 46 48 
25 24 25 28 32 30 41 36 38 40 31 38 30 31 30 38 37 38 31 36 40 34 30 36 40 39 42 42 43 44 42 43 44 44 44 45 45 48 46 48 
25 27 36 37 33 35 38 37 41 40 37 40 30 35 41 30 40 37 33 34 40 33 33 34 34 35 41 44 43 43 42 45 45 46 47 45 46 47 47 47 
30 37 40 30 34 39 31 40 40 41 37 35 35 41 35 39 38 40 34 34 36 39 40 42 43 34 43 43 44 44 43 44 47 47 47 46 47 47 48 49 
29 32 33 30 35 40 35 41 30 31 34 37 36 37 32 33 33 40 33 33 34 40 42 42 42 42 43 44 45 46 46 49 47 46 46 47 47 48 48 48 
41 31 41 37 33 41 39 37 41 37 36 40 33 32 38 33 41 33 40 40 42 44 42 43 43 43 44 47 46 46 47 48 47 47 46 47 48 48 48 49 
38 43 36 33 41 38 35 36 35 41 39 37 31 39 38 41 39 34 34 42 44 42 43 43 44 43 45 45 46 46 48 47 46 47 47 48 47 49 50 49 
31 32 41 39 34 40 35 34 36 36 30 32 37 32 33 34 34 42 35 42 43 43 44 43 44 45 46 45 46 47 47 47 47 46 47 48 48 49 49 50 
