64 63 59 58 63 64 58 59 56 61 53 55 52 52 52 53 51 52 49 49 50 46 51 49 49 46 48 43 46 47 46 54 49 52 53 64 53 65 57 61 
64 65 64 59 57 57 60 55 56 55 54 52 52 51 51 51 53 49 49 47 50 50 49 48 48 47 44 47 47 50 50 50 53 53 53 61 58 55 61 55 
57 64 64 64 59 65 54 55 53 52 53 55 52 50 54 52 48 48 48 52 48 50 48 48 44 46 47 49 49 46 53 51 53 51 64 64 62 53 52 52 
57 59 59 64 56 57 63 53 52 53 54 52 50 50 51 50 50 48 47 51 50 47 48 47 45 45 47 49 52 48 51 55 51 53 60 58 62 52 47 46 
60 65 58 57 59 57 56 51 49 61 53 50 50 48 48 49 51 47 47 44 45 53 49 50 50 49 45 49 47 55 59 53 52 50 50 51 56 48 48 49 
65 57 58 62 54 53 53 49 49 52 52 50 48 47 47 47 49 47 48 48 48 50 50 51 51 48 49 46 46 63 60 53 50 49 49 51 50 49 49 50 
65 64 62 61 53 60 49 49 48 52 49 50 48 48 48 50 45 48 48 46 60 49 50 47 46 47 46 46 47 63 51 51 49 49 50 54 47 49 47 46 
63 54 54 52 52 50 51 50 49 48 48 46 48 47 48 47 50 49 49 60 49 61 47 48 45 46 44 48 46 50 51 47 50 49 50 49 54 48 48 45 
54 60 52 52 50 52 49 48 48 46 46 47 48 46 47 50 48 48 48 51 62 48 47 47 47 44 46 47 46 50 47 49 50 48 49 55 47 46 46 46 
53 60 51 52 54 56 51 49 49 49 46 47 45 45 45 46 44 46 43 50 47 49 44 44 45 46 41 45 43 43 51 48 53 51 51 49 60 49 52 60 
52 53 55 52 55 61 49 49 47 47 47 46 45 45 44 43 46 43 42 49 48 44 45 42 43 45 45 43 43 43 50 53 51 52 52 51 49 54 61 56 
62 53 54 52 53 48 52 48 49 50 47 44 45 44 47 45 43 41 40 45 47 48 43 41 47 42 44 43 44 45 50 48 52 60 48 52 53 62 57 64 
52 50 47 46 47 49 46 51 50 50 43 46 44 44 44 42 41 40 39 47 46 45 44 42 41 44 40 44 43 46 50 50 54 60 53 54 58 63 59 65 
49 48 47 48 48 45 50 49 50 50 46 44 44 43 41 42 40 40 38 45 46 43 39 41 42 39 43 45 44 44 49 52 55 62 60 63 57 58 65 63 
48 48 57 53 48 49 45 48 44 43 43 43 40 38 38 40 40 37 35 44 43 37 41 42 42 42 48 48 51 52 52 65 63 64 65 64 60 59 57 62 
52 50 52 52 51 46 48 43 42 42 41 42 38 38 38 37 38 35 35 40 41 39 42 42 42 46 46 52 52 53 62 63 59 59 65 62 59 56 57 64 
48 63 49 46 53 46 45 41 39 39 42 37 37 35 35 39 34 34 33 43 37 43 44 47 48 48 54 54 55 56 54 54 59 56 55 56 57 57 64 65 
63 49 55 46 42 41 40 39 38 40 38 39 35 35 35 34 36 34 33 37 43 39 46 47 51 54 61 63 63 61 59 62 62 63 61 56 60 63 63 55 
51 58 44 42 43 40 39 41 38 37 40 35 36 34 35 37 33 33 32 40 37 46 48 50 52 61 62 54 57 58 63 57 56 63 56 53 57 60 58 59 
49 48 49 51 47 48 52 51 52 53 61 50 55 53 53 50 63 49 53 55 44 46 45 45 46 48 48 53 51 51 50 53 50 51 52 54 55 58 57 57 
49 50 48 51 49 50 51 53 61 51 51 61 53 54 55 52 50 61 62 63 45 46 46 48 47 49 52 51 51 52 51 51 52 53 53 60 57 57 64 58 
48 49 53 52 49 53 51 55 60 63 52 51 61 57 48 60 53 63 64 65 47 43 47 47 51 50 53 51 51 50 52 50 60 54 56 63 57 58 64 58 
50 51 53 56 60 52 62 53 61 51 52 52 62 62 55 56 55 54 61 64 46 49 47 48 51 51 50 51 50 52 52 55 53 61 57 57 58 64 58 64 
50 52 55 60 60 56 60 62 62 53 51 60 65 59 63 55 59 58 62 57 49 46 49 49 49 50 50 51 49 53 55 53 61 57 63 58 57 58 64 64 
52 52 49 52 53 54 62 65 54 53 60 55 58 64 59 59 54 55 64 58 47 49 49 48 48 50 51 50 50 53 54 51 62 61 61 63 60 65 55 62 
50 53 51 54 61 63 63 55 56 57 62 59 65 61 56 58 65 64 63 63 48 49 48 49 50 49 50 50 50 52 61 54 55 55 56 59 59 56 57 58 
52 49 62 63 55 63 58 58 66 55 62 62 60 59 59 56 56 58 65 60 49 47 49 47 47 51 49 50 49 55 52 65 63 64 59 54 63 58 58 65 
50 61 53 65 61 63 63 67 67 56 64 65 60 60 58 65 61 61 65 54 48 49 46 47 49 49 51 49 49 53 56 53 63 58 61 56 65 59 66 65 
61 51 65 60 55 62 66 59 67 60 66 65 59 60 59 60 65 65 54 64 49 47 49 47 49 51 49 49 50 61 52 64 59 65 61 64 65 65 66 67 
61 54 56 56 54 61 58 59 64 58 65 65 58 65 54 59 58 55 56 63 50 49 56 56 56 61 59 58 60 61 56 64 59 56 57 58 67 67 67 67 
61 56 55 55 56 62 59 64 64 59 65 57 54 60 56 62 55 57 56 56 51 54 62 63 63 64 57 61 56 56 65 58 57 57 59 66 67 67 67 68 
60 61 56 63 63 65 58 58 62 62 58 61 56 58 65 63 65 62 54 60 52 63 58 59 61 59 57 63 63 63 59 57 59 66 59 68 66 67 65 59 
56 63 64 60 65 58 65 62 62 57 55 62 59 59 59 57 64 62 55 64 55 55 65 59 55 56 63 63 58 64 56 58 66 67 68 66 68 59 65 65 
58 58 65 59 57 65 62 57 55 56 55 58 63 66 57 65 56 65 54 59 54 58 60 62 63 57 63 63 64 66 57 66 67 68 65 69 65 66 65 59 
64 57 62 63 63 62 64 63 57 63 56 57 54 58 64 61 61 65 60 60 63 57 56 57 58 63 54 58 61 55 63 63 59 58 58 65 66 64 63 57 
63 63 56 62 62 56 57 63 57 57 60 65 64 64 58 55 59 60 60 55 65 56 64 58 65 55 63 61 62 62 58 58 64 57 63 58 59 63 64 59 
57 55 58 57 61 63 65 64 63 63 63 59 58 65 54 60 59 55 62 62 65 58 58 62 62 55 56 56 63 58 63 67 64 63 57 66 63 59 65 59 
61 63 55 55 57 57 64 63 57 63 65 56 60 65 55 54 56 57 57 62 63 67 56 57 56 56 55 64 63 58 65 56 62 56 64 63 66 59 65 59 
61 60 56 57 62 58 63 63 57 58 55 65 60 54 60 55 62 56 56 63 68 57 63 61 57 60 56 57 63 56 56 57 64 64 57 66 64 65 66 66 
56 61 62 57 63 63 63 64 57 64 57 59 59 55 61 62 57 63 57 58 65 63 58 56 56 62 57 62 63 57 62 62 63 58 64 59 65 66 59 66 
