45 45 44 43 45 44 38 40 36 35 33 37 31 30 30 33 27 37 31 29 29 26 30 30 30 27 34 25 30 32 33 33 34 34 34 35 36 36 35 35 
44 44 44 41 41 41 40 35 35 36 34 33 30 30 28 31 36 29 29 27 29 28 30 30 32 28 26 32 32 32 31 34 34 35 35 35 37 35 36 36 
45 44 42 40 44 38 36 35 35 32 36 29 30 27 37 31 31 28 28 30 26 33 31 33 24 31 31 33 32 34 34 32 35 36 36 37 33 35 34 34 
43 42 41 37 40 36 35 36 34 30 32 33 27 26 34 31 29 28 24 31 30 28 34 35 27 30 32 32 35 33 34 36 36 37 34 35 37 34 34 34 
44 41 44 40 32 32 32 31 29 40 36 31 27 25 25 24 29 24 25 23 26 28 35 35 35 37 33 35 35 35 35 38 36 35 35 37 35 34 32 32 
44 40 38 36 35 32 33 29 29 35 32 28 25 24 24 24 26 26 27 25 28 33 35 35 35 37 35 35 35 36 34 38 35 35 35 34 34 32 31 31 
38 41 36 32 35 33 27 27 25 32 27 27 25 24 24 29 23 26 24 30 31 36 35 35 35 33 36 36 38 36 38 33 34 32 32 34 33 31 29 28 
41 33 36 31 27 26 28 24 24 26 26 23 23 24 25 25 29 25 25 33 34 34 36 35 35 36 33 39 38 37 34 36 32 32 32 32 30 28 28 29 
34 38 30 27 28 29 24 26 24 25 23 24 25 23 25 30 24 24 24 32 33 35 35 36 34 32 37 38 40 35 37 32 33 32 31 31 29 30 29 28 
32 33 30 31 36 33 27 24 24 24 24 24 22 20 19 20 16 20 17 34 30 34 24 26 27 28 27 29 26 26 35 32 34 32 31 30 33 30 33 35 
31 33 33 30 31 29 25 24 24 24 22 24 19 19 17 18 20 17 16 34 29 27 27 27 27 26 30 26 26 27 33 35 31 33 32 30 30 35 36 37 
34 31 32 29 30 24 23 24 25 26 24 17 18 17 21 17 19 16 17 27 30 24 26 25 30 28 23 25 24 24 33 30 33 34 29 32 34 38 39 40 
30 28 24 22 22 24 22 25 25 27 19 20 18 16 16 16 14 18 16 29 27 30 26 27 26 24 25 23 23 25 33 32 34 34 33 36 38 39 41 41 
26 25 23 24 23 21 24 26 27 27 21 16 17 14 15 14 16 17 17 27 31 26 25 27 25 25 23 26 22 23 32 33 35 35 36 37 39 40 41 44 
25 24 33 31 23 24 21 26 23 22 17 22 18 18 19 15 15 14 12 27 26 17 21 19 19 23 30 25 28 30 34 38 37 38 38 39 37 43 42 42 
29 29 28 29 30 24 25 22 20 20 20 18 19 17 17 15 15 12 12 22 23 20 19 20 21 25 26 30 32 33 35 37 38 40 41 38 41 42 43 43 
24 32 30 25 30 23 26 21 20 20 21 20 17 14 14 15 12 11 10 25 16 19 21 25 27 29 26 32 33 34 39 36 40 40 41 39 44 44 46 47 
34 27 31 25 20 23 19 20 18 20 17 20 16 15 12 11 12 11 10 14 20 16 25 25 30 31 36 34 36 35 37 42 40 41 42 44 42 46 46 48 
27 33 24 20 22 19 20 20 18 17 21 16 13 13 12 13 10 10 09 17 13 23 27 27 29 36 33 34 36 38 42 39 41 41 43 41 45 46 47 47 
26 25 28 28 24 26 29 32 32 32 33 29 34 32 31 28 31 25 29 31 21 23 26 27 28 29 31 32 32 33 33 37 35 36 37 40 40 45 43 43 
27 27 26 27 26 29 32 32 33 30 31 33 31 31 31 29 25 31 32 33 22 25 28 28 29 29 32 33 34 35 33 36 37 39 38 40 44 43 44 45 
25 27 29 29 29 31 31 32 32 35 30 34 31 31 25 28 30 34 35 36 24 28 29 30 30 32 34 34 35 34 37 34 39 39 43 43 43 44 44 45 
28 29 30 31 32 31 33 32 32 30 32 28 30 30 29 31 35 35 38 38 28 28 31 31 33 35 35 36 36 37 37 40 39 40 43 43 43 44 44 46 
28 30 30 30 30 33 31 33 33 30 27 31 32 30 32 34 36 36 40 42 27 30 31 32 35 34 35 35 37 38 40 38 40 42 42 43 43 45 43 44 
29 29 26 29 31 31 35 34 35 30 30 37 35 37 38 35 32 39 37 37 29 31 32 31 31 35 35 37 37 38 39 39 42 42 42 43 46 46 47 48 
27 28 28 30 31 34 34 36 38 33 33 35 38 38 39 35 38 37 38 39 30 33 31 34 35 36 36 37 37 38 39 41 42 42 43 44 45 48 48 48 
30 26 33 33 30 35 36 39 39 31 37 37 38 38 38 35 39 39 42 43 32 29 33 33 34 36 40 38 38 40 40 43 43 44 45 46 48 48 47 47 
27 32 29 33 36 37 39 39 40 39 38 41 39 39 37 39 37 43 42 44 32 34 32 34 36 38 37 37 38 40 42 42 46 45 45 46 48 46 47 48 
30 27 34 35 36 39 39 40 41 38 42 38 38 38 39 35 41 42 43 42 34 32 36 35 36 36 38 38 38 41 41 44 44 45 45 48 47 48 48 49 
32 33 33 35 38 38 36 38 38 38 38 40 36 36 37 38 36 41 39 38 34 35 37 35 35 36 35 39 39 39 43 44 44 43 43 44 42 46 44 44 
32 33 35 35 37 39 37 38 37 37 38 37 37 37 36 39 40 38 38 38 33 37 35 36 35 36 38 39 41 42 43 45 43 43 42 43 46 44 46 47 
35 35 38 37 38 36 40 38 38 38 39 37 37 35 40 38 42 39 39 39 36 35 36 36 38 37 37 41 43 44 45 43 43 42 46 43 42 46 48 49 
35 34 34 35 36 37 36 37 38 40 36 38 36 36 38 40 37 40 38 39 35 36 37 36 36 39 40 43 44 46 42 44 43 42 42 44 44 47 48 51 
35 34 35 35 36 35 38 39 38 40 39 36 36 36 37 36 39 39 39 37 36 35 36 35 40 39 42 45 45 46 44 42 42 41 44 43 46 50 48 50 
34 34 39 38 37 38 37 40 39 39 36 34 36 36 36 38 41 39 41 42 36 40 41 42 43 42 43 46 46 46 42 46 46 48 49 46 48 51 52 52 
36 37 38 38 39 37 39 39 38 38 36 36 36 36 37 40 39 42 42 42 40 40 43 44 44 43 45 46 47 48 45 45 49 49 49 49 50 52 52 52 
35 40 37 37 41 38 41 38 38 38 34 37 37 39 40 41 42 42 42 42 41 45 45 44 44 45 45 47 47 47 47 51 50 49 49 50 53 53 53 60 
40 37 41 38 37 38 38 39 38 38 37 35 40 39 41 42 43 42 43 42 43 45 44 45 44 46 46 46 47 49 50 50 49 50 50 51 53 61 60 53 
38 42 37 37 38 38 38 38 37 37 34 38 39 40 40 43 42 42 43 44 45 45 44 45 46 46 46 49 48 49 50 50 49 50 51 52 53 53 52 53 
38 39 37 37 38 38 38 37 37 37 37 39 39 41 42 43 43 44 43 44 45 45 46 45 46 46 47 49 49 50 50 50 51 51 52 53 60 53 53 54 
