10 10 10 09 10 10 12 10 12 13 14 12 16 15 15 14 17 14 16 17 16 17 16 16 16 16 14 16 13 13 11 12 09 10 11 11 12 12 11 11 
10 09 10 10 11 11 11 13 14 12 12 16 15 16 16 14 14 17 17 17 15 16 16 15 15 16 16 13 12 12 11 09 11 11 11 12 12 11 11 11 
10 10 09 10 10 12 11 14 14 16 14 14 16 17 13 16 17 18 18 16 17 17 15 13 17 15 15 12 11 10 11 11 11 12 11 12 14 11 10 10 
09 10 11 11 10 12 14 15 16 15 14 16 18 18 15 16 18 18 19 16 15 16 13 13 16 14 13 11 09 10 10 11 12 13 12 12 12 10 09 09 
10 11 10 13 14 15 16 17 18 12 14 19 19 19 19 20 16 19 17 18 16 16 14 12 12 11 11 07 06 12 12 07 10 08 07 12 14 11 11 12 
10 12 12 13 16 16 17 18 20 15 16 19 19 20 20 19 18 17 15 17 17 14 12 10 10 09 09 06 06 09 10 10 07 08 08 13 11 12 13 13 
12 11 17 17 15 17 18 21 22 16 21 19 19 17 17 16 21 16 16 15 14 15 10 08 07 10 04 05 03 13 07 06 08 10 11 12 12 13 14 14 
12 15 14 18 18 19 20 21 22 22 20 22 18 18 16 16 14 16 15 14 12 10 08 07 07 06 07 04 04 05 08 06 10 10 13 13 14 15 15 14 
13 13 17 18 18 19 21 23 23 21 23 18 17 16 16 13 16 16 16 11 11 09 08 06 06 07 04 04 03 07 05 09 11 11 11 14 14 13 15 15 
15 14 16 13 13 14 12 16 14 14 19 19 18 17 17 16 16 15 14 10 11 09 13 10 10 09 09 08 08 08 08 10 10 11 12 13 13 14 13 13 
15 14 14 12 12 14 16 14 14 14 18 18 17 16 16 14 16 14 15 09 12 12 10 10 09 08 08 08 10 11 11 09 12 12 12 12 14 13 13 13 
14 15 10 11 16 14 15 13 14 15 18 18 16 16 16 15 14 16 17 13 11 13 10 10 09 08 07 10 11 12 10 14 12 13 14 14 12 12 11 11 
14 12 14 12 13 13 13 16 14 14 18 17 18 16 15 14 16 17 17 11 11 09 11 09 08 09 10 11 12 14 13 13 15 14 13 12 12 11 11 12 
11 15 11 12 12 12 14 14 13 12 17 16 15 15 15 15 16 17 18 09 09 10 10 09 09 09 10 13 13 15 12 14 12 13 11 12 11 12 10 11 
12 12 11 09 13 13 15 13 13 13 16 16 14 14 14 16 17 18 19 10 10 16 11 12 12 11 09 13 11 11 12 12 10 10 10 11 12 11 11 11 
11 09 12 11 10 14 14 13 14 15 16 15 14 15 16 18 18 19 19 13 10 13 12 13 14 12 12 11 10 10 11 11 10 10 10 11 11 11 11 11 
12 11 08 10 12 15 13 14 14 14 16 12 15 15 16 18 20 20 19 10 16 11 13 11 10 11 13 11 11 11 11 09 09 09 10 12 11 11 10 10 
10 09 11 12 13 14 15 14 14 14 14 16 15 16 17 18 19 18 19 16 13 17 11 12 10 11 09 12 10 11 10 10 11 10 09 09 11 09 10 11 
10 11 11 13 13 15 13 14 15 15 16 15 16 17 17 19 19 20 19 15 18 11 11 11 11 09 10 11 09 09 10 09 09 09 09 11 10 11 11 11 
10 10 10 07 10 10 07 09 08 08 07 09 08 09 09 10 11 12 12 12 12 12 12 12 13 12 14 12 12 13 14 12 16 14 14 13 15 13 14 15 
10 07 10 08 08 09 09 08 07 08 08 08 09 10 10 12 12 12 11 11 12 12 13 13 13 11 13 13 14 12 14 15 14 14 14 15 13 15 15 15 
10 10 05 06 10 07 10 07 07 07 08 11 11 10 11 12 14 11 09 09 12 12 13 13 12 14 11 15 14 16 14 15 15 16 12 14 15 15 14 14 
08 05 07 06 07 08 06 08 07 09 09 10 09 11 13 11 11 10 09 09 11 13 13 14 13 13 15 13 15 13 14 13 16 15 15 15 16 14 15 15 
05 08 05 06 07 05 07 08 08 10 10 11 11 12 12 12 10 09 08 08 12 13 14 15 12 15 14 16 17 12 13 15 16 16 14 16 15 15 15 17 
05 05 08 07 07 07 07 07 07 09 09 07 09 08 08 09 10 08 08 08 12 12 12 13 13 15 16 17 18 14 14 19 15 15 16 15 12 15 13 13 
06 06 07 06 07 07 07 07 07 08 08 08 08 07 07 10 09 08 09 09 13 13 13 14 15 16 17 19 19 16 16 17 16 16 17 14 14 13 11 11 
06 08 07 06 08 07 08 07 07 09 07 12 08 08 08 10 07 09 08 08 12 11 15 16 17 17 19 20 22 14 19 13 15 12 12 13 15 12 12 12 
08 07 08 07 06 06 07 09 07 08 10 07 09 08 08 07 10 08 09 09 13 14 16 17 18 19 20 23 23 19 14 19 12 13 12 12 10 13 11 11 
06 09 06 06 06 07 07 06 05 08 06 09 08 07 07 10 08 09 08 10 13 15 17 19 19 19 22 22 23 17 20 13 13 12 12 10 12 11 11 10 
07 07 07 05 10 09 05 07 06 06 08 08 08 08 08 08 11 10 10 10 13 14 12 12 12 12 10 13 11 11 14 13 11 10 10 10 09 10 10 11 
07 06 08 04 07 08 06 06 05 05 06 08 08 09 09 09 10 10 10 10 13 13 12 11 11 12 12 11 10 10 11 12 10 10 09 10 09 11 09 09 
08 07 03 04 09 04 09 07 08 08 08 06 09 09 09 11 09 10 08 08 13 13 11 09 13 11 13 10 10 11 12 10 10 09 10 09 13 10 10 10 
06 04 04 01 04 06 03 08 07 09 08 09 08 10 11 09 11 07 08 09 12 11 09 09 11 12 09 12 10 10 10 10 09 09 10 10 09 10 09 10 
03 04 01 03 05 02 07 08 07 08 09 09 11 11 08 11 08 09 07 09 12 10 10 09 10 09 10 10 10 09 10 09 09 08 09 09 10 09 09 09 
03 03 08 07 05 06 06 09 07 07 08 09 08 08 08 09 09 09 09 09 10 11 10 09 09 09 10 09 09 09 09 09 08 08 08 09 09 09 09 09 
05 06 06 07 08 07 08 07 07 07 07 09 08 08 09 09 09 09 08 08 09 10 09 09 09 09 09 09 09 09 08 09 08 08 09 08 09 09 09 10 
04 08 06 06 10 07 10 08 06 06 09 07 08 08 08 09 11 08 08 08 10 09 09 08 08 10 11 09 08 08 09 08 08 08 09 09 08 09 09 10 
09 07 09 07 06 08 06 06 06 07 07 09 08 08 09 10 08 08 08 08 09 09 08 08 08 09 09 09 08 08 08 09 09 09 09 08 10 10 10 10 
06 10 06 06 07 06 07 07 05 07 09 07 09 08 09 08 08 08 09 08 09 08 08 08 08 09 08 08 07 08 09 08 09 09 09 10 09 10 10 10 
07 07 06 06 07 06 06 07 07 07 08 08 09 09 09 08 08 08 08 08 08 08 08 08 08 08 08 08 08 08 09 09 09 09 09 10 10 10 10 10 
