08 07 08 08 07 07 07 07 05 05 04 05 03 02 02 03 01 04 03 03 03 04 04 04 05 06 05 07 06 06 05 07 05 05 05 07 03 09 06 06 
08 08 07 07 07 07 08 05 05 05 03 03 02 02 01 04 03 03 03 03 04 04 05 05 05 05 07 06 06 06 06 05 05 04 04 05 08 06 06 06 
07 07 08 07 08 07 06 05 05 03 04 03 02 01 04 02 05 04 04 04 05 05 05 04 07 06 05 05 04 04 06 07 04 03 09 05 09 06 06 07 
07 07 07 08 07 05 06 05 03 03 04 03 01 00 04 04 03 05 05 04 05 05 04 05 06 07 06 04 04 05 05 05 03 02 09 07 05 07 05 05 
08 07 07 07 07 06 05 03 02 05 03 02 01 02 03 01 05 06 08 06 06 07 06 04 04 05 05 03 01 09 07 04 03 04 05 03 07 06 08 09 
07 08 07 05 05 05 04 02 02 03 02 01 03 03 03 05 06 09 10 06 06 06 04 04 04 03 04 01 02 06 06 03 05 03 03 06 06 09 10 11 
07 07 07 05 04 04 01 01 00 02 01 02 04 05 06 06 08 10 11 06 07 05 04 02 02 05 00 01 01 05 02 06 04 06 07 08 08 10 10 10 
07 04 04 03 02 02 02 01 01 01 03 03 06 06 07 09 11 12 12 06 04 05 03 02 02 00 03 01 01 02 05 03 07 06 07 08 12 10 11 11 
05 05 03 02 01 02 01 01 01 01 02 05 06 06 08 10 11 11 12 04 05 02 02 02 01 03 00 01 00 02 02 06 05 07 07 12 10 11 10 13 
03 03 03 03 06 05 03 03 03 04 04 05 06 06 06 08 08 12 12 03 04 03 08 08 08 07 12 06 08 09 04 06 07 07 08 09 10 11 10 10 
03 04 04 03 04 04 03 04 04 04 04 06 06 07 07 09 11 12 12 03 05 06 08 09 10 08 08 09 11 12 05 06 08 08 09 09 11 10 10 10 
04 03 04 03 04 02 05 05 05 06 06 05 08 08 10 10 14 13 14 06 04 10 10 12 06 11 06 11 11 11 06 08 09 08 10 11 10 10 10 10 
03 02 02 02 02 03 02 04 05 08 05 08 08 09 11 14 13 16 15 05 08 07 12 12 11 10 15 12 13 10 07 08 07 09 11 10 11 11 10 10 
01 02 01 01 03 01 05 06 06 08 08 08 09 09 12 12 14 14 14 07 06 11 13 13 12 15 11 11 13 13 08 08 10 10 10 11 10 10 09 09 
01 01 05 04 03 04 05 08 08 08 08 09 12 12 12 14 15 14 13 08 09 13 13 13 13 12 09 11 09 09 07 08 09 09 09 09 10 08 08 08 
03 02 04 05 06 04 07 08 08 09 09 11 12 12 13 13 15 13 15 10 11 12 13 12 12 10 11 09 08 08 08 09 09 08 08 08 09 08 08 09 
02 06 04 04 09 06 07 08 09 10 11 12 13 12 12 15 12 15 16 10 14 15 12 10 10 09 12 09 09 10 09 10 08 08 08 09 07 08 08 08 
06 04 08 07 06 07 08 10 10 10 10 12 11 12 14 14 16 17 17 15 13 14 12 11 09 10 07 11 09 09 09 09 10 08 07 07 09 08 08 08 
04 08 06 06 08 08 09 10 09 10 12 12 14 13 14 16 15 16 17 12 15 12 10 09 10 07 09 08 09 07 09 08 07 06 07 09 07 08 08 08 
05 05 05 07 06 05 11 08 10 11 11 11 12 13 14 13 16 12 12 12 11 12 11 11 11 11 13 11 10 10 08 09 06 05 05 05 02 05 02 02 
05 06 05 06 08 09 08 11 11 11 11 11 14 14 15 14 14 12 13 13 11 11 11 12 12 12 12 10 10 09 08 07 05 04 03 04 05 02 03 04 
05 05 09 10 05 10 13 11 11 11 11 15 15 16 13 16 10 12 10 09 11 10 12 12 11 13 09 09 07 07 08 08 04 02 06 03 02 03 04 05 
06 10 09 13 12 11 14 13 12 12 14 14 17 17 15 11 14 09 10 10 10 12 11 13 13 10 11 08 07 08 05 05 03 02 02 03 02 04 04 06 
09 08 12 12 12 14 12 10 12 12 13 16 16 16 13 15 10 11 11 11 12 12 14 15 10 12 07 07 06 06 06 03 02 00 01 01 03 05 05 05 
10 10 09 08 12 11 10 11 11 14 13 14 12 12 12 10 10 09 07 06 10 10 10 08 08 08 07 06 06 04 03 02 02 02 02 03 06 06 06 07 
09 09 10 10 08 10 10 12 11 14 13 12 12 10 10 09 10 06 07 07 10 09 08 07 07 08 06 06 04 03 03 02 02 03 03 03 06 07 08 09 
11 09 08 09 09 10 13 11 11 12 13 14 10 08 07 09 06 07 06 06 10 12 08 06 06 06 09 04 02 03 01 00 03 04 05 07 06 09 08 08 
08 09 09 10 10 11 10 11 11 13 10 11 08 08 07 06 07 06 06 07 08 08 08 06 05 06 04 03 02 00 02 02 05 05 06 08 09 07 09 10 
08 08 09 10 09 09 11 12 12 09 11 09 08 07 07 07 06 07 07 06 08 07 05 06 04 04 03 01 01 02 01 03 05 06 07 09 08 10 10 11 
09 08 09 11 07 07 09 09 09 10 09 08 09 08 08 07 07 05 05 05 07 05 06 05 05 04 07 03 05 06 03 04 06 07 07 08 11 10 09 09 
09 10 08 09 08 09 09 10 08 08 10 08 08 07 07 06 06 05 06 06 07 07 05 06 06 03 04 06 06 07 03 05 07 08 09 07 11 09 11 12 
08 08 13 11 08 09 12 08 06 06 08 10 08 08 07 07 04 06 06 06 06 04 06 07 03 06 03 06 07 07 05 08 10 11 09 12 07 11 10 10 
09 11 09 10 10 09 09 07 07 06 07 07 09 08 06 06 06 05 06 07 05 05 06 06 06 05 08 07 08 08 09 09 11 12 11 09 13 10 11 11 
09 09 10 09 08 09 08 07 05 06 07 08 07 07 05 06 05 07 07 07 04 05 08 07 06 08 06 07 09 09 08 11 11 12 11 13 10 11 12 11 
10 09 07 05 08 07 08 06 05 05 06 08 07 07 07 06 06 07 07 07 05 08 07 08 09 07 05 08 07 07 09 09 10 10 10 10 11 10 09 09 
08 07 07 04 04 07 07 05 06 06 08 07 07 06 06 07 07 07 06 06 07 07 09 08 08 07 07 07 07 07 08 09 10 10 10 10 11 09 10 11 
09 07 03 04 05 07 04 06 06 06 07 10 07 06 06 06 08 06 06 07 08 11 08 06 06 06 09 08 08 08 09 11 10 10 10 11 09 11 10 10 
05 03 05 05 05 05 07 06 06 06 08 07 06 06 06 07 06 07 06 07 07 09 07 07 06 07 06 07 07 09 09 10 11 10 10 10 11 09 10 11 
04 05 04 05 05 07 05 06 06 07 07 07 06 06 06 06 06 06 06 06 10 08 06 06 06 05 07 08 09 08 10 10 10 09 10 11 09 11 10 12 
04 05 05 05 05 06 06 07 06 07 06 06 06 06 06 06 06 06 07 07 08 07 07 06 06 06 07 08 09 09 10 10 10 10 10 10 10 12 11 12 
