04 04 04 05 04 04 02 04 02 02 01 02 02 02 02 02 03 03 02 02 02 03 04 05 06 06 08 07 05 05 04 06 03 03 04 06 05 09 08 08 
04 05 04 04 03 03 04 02 02 02 01 01 02 02 02 02 03 02 03 02 02 03 06 06 07 05 08 05 06 05 04 04 04 05 04 06 08 08 07 07 
04 04 06 04 05 02 03 02 02 01 02 04 03 03 03 03 03 03 04 03 04 06 07 07 07 09 04 05 04 03 05 04 05 04 08 07 10 07 07 07 
05 05 03 02 04 02 02 02 01 02 02 02 03 03 03 02 04 04 04 04 06 06 08 09 05 05 08 04 04 03 04 06 04 06 09 09 07 07 05 05 
05 03 04 03 00 00 01 01 00 03 03 01 02 01 01 04 05 05 05 05 06 06 09 07 07 09 07 03 02 08 07 04 05 03 03 06 09 06 06 07 
04 02 02 03 02 01 01 00 00 02 03 02 01 02 03 04 05 06 07 05 06 08 07 05 05 05 05 02 02 06 05 05 03 04 04 08 07 07 08 09 
02 03 02 01 02 02 00 00 00 03 01 01 03 03 04 05 06 08 08 08 07 10 06 04 03 05 01 01 00 07 03 03 04 04 05 08 06 09 09 09 
03 01 02 01 00 00 01 00 00 01 01 01 02 03 06 06 08 08 09 08 06 05 04 03 03 02 02 01 01 02 02 02 03 04 07 07 10 10 10 09 
01 02 00 00 00 01 00 00 00 01 01 02 05 06 06 07 08 09 08 05 05 04 04 01 01 02 01 01 00 01 01 03 06 05 07 10 09 09 11 11 
01 01 01 03 04 03 03 02 03 03 02 03 03 03 03 05 06 09 09 05 06 04 08 07 07 05 10 05 07 08 02 04 05 05 06 07 06 08 06 06 
01 01 02 02 03 04 02 03 03 04 02 04 03 05 04 06 08 10 10 04 05 07 07 08 08 07 06 08 09 09 05 04 06 05 06 06 08 06 07 08 
02 01 05 04 02 02 03 04 04 04 04 02 05 05 07 08 10 10 10 07 05 08 09 10 04 09 06 09 07 07 04 08 06 05 08 07 06 07 07 07 
02 04 02 03 02 02 03 03 04 06 04 06 04 06 08 10 09 10 10 05 09 06 10 10 09 07 11 07 09 08 05 05 05 05 07 06 07 07 07 08 
01 01 03 03 03 03 03 05 06 07 06 05 07 07 08 09 10 11 11 08 05 09 11 12 08 12 08 08 09 11 05 05 06 05 06 07 06 08 06 07 
03 02 05 03 02 03 03 05 05 05 06 07 09 09 10 09 11 12 12 08 08 11 08 08 08 08 06 08 06 06 05 07 07 07 08 06 07 07 07 07 
04 02 03 03 04 03 05 05 06 07 07 08 10 09 09 09 11 12 13 09 09 09 08 09 09 07 08 06 06 06 06 06 08 07 07 06 07 07 07 08 
02 05 02 03 07 05 04 06 07 08 08 12 10 10 10 11 13 13 13 08 11 07 08 05 05 06 07 06 07 07 07 10 08 06 06 08 07 07 07 08 
05 04 06 06 05 05 06 08 08 08 10 09 10 10 11 12 13 13 13 11 08 10 05 06 05 06 05 07 06 08 08 08 07 07 06 06 08 09 08 07 
04 06 04 04 06 06 07 08 07 08 09 10 10 12 11 13 13 13 14 08 11 06 06 06 06 04 06 07 08 06 08 07 06 07 07 08 07 07 06 07 
04 04 04 05 05 04 08 04 05 05 04 05 02 02 02 03 03 05 03 03 07 08 05 03 03 04 01 06 04 03 04 04 05 03 03 04 03 05 05 06 
04 03 04 06 06 05 06 05 05 05 03 03 02 03 02 03 05 03 03 04 06 07 03 04 02 04 05 03 04 03 03 05 03 04 03 05 05 06 06 07 
04 04 07 07 04 07 03 05 03 03 04 01 03 02 05 04 04 03 02 02 07 01 03 01 06 03 05 05 06 05 05 02 03 03 05 04 06 07 07 07 
04 06 06 08 07 04 07 03 04 04 01 04 02 03 04 02 03 02 02 03 01 04 00 01 02 05 03 06 06 04 02 04 03 03 04 06 05 06 07 09 
05 05 08 09 05 08 03 04 03 02 04 02 03 03 02 03 02 03 01 02 05 01 02 00 03 02 05 07 07 02 04 02 04 03 05 05 06 08 08 09 
06 05 06 04 04 03 03 02 01 02 02 01 02 02 02 02 04 02 02 02 01 04 04 05 06 05 07 07 07 02 03 06 06 07 07 07 07 09 08 08 
06 04 05 05 03 03 03 01 01 01 02 01 02 01 01 01 03 02 03 04 03 04 06 05 05 05 08 07 08 04 06 06 07 07 08 07 08 08 08 08 
05 05 03 02 03 02 02 01 00 02 01 05 02 02 02 04 00 03 03 04 04 07 06 05 05 08 04 08 08 04 07 08 08 07 07 08 10 08 08 09 
05 02 03 01 01 01 01 01 00 01 03 00 02 01 02 01 05 04 04 04 05 06 05 05 05 05 09 07 08 08 07 09 07 07 07 09 08 09 08 09 
01 03 00 01 00 01 00 00 00 01 00 02 01 02 01 05 03 04 04 05 06 05 05 05 06 09 07 10 10 07 09 07 07 07 08 08 08 08 07 08 
01 01 01 00 03 02 04 02 03 03 01 02 02 02 02 02 04 03 03 03 05 05 05 04 04 04 04 06 06 07 07 07 07 08 08 08 12 09 09 10 
01 02 02 01 03 03 02 03 03 04 02 03 02 03 03 02 04 03 04 05 05 06 04 05 04 05 05 07 07 07 06 07 08 09 10 10 10 10 10 11 
02 01 00 02 02 04 03 03 03 03 02 00 03 03 03 04 00 04 04 04 06 03 04 05 05 05 07 07 07 08 07 09 11 12 08 12 08 10 09 09 
01 02 02 04 04 02 04 03 03 03 01 03 03 04 03 01 05 03 04 05 04 05 06 05 05 05 06 08 08 08 10 10 13 13 12 09 13 10 10 08 
02 02 03 04 02 04 03 03 04 04 03 03 05 05 02 05 03 05 05 06 05 04 05 05 04 06 07 08 07 08 09 12 12 15 10 13 09 09 10 09 
02 02 03 02 02 02 02 03 03 03 02 04 03 03 04 03 03 05 05 06 04 07 06 06 06 06 06 08 08 08 10 09 09 08 08 09 09 08 09 09 
02 03 02 03 02 02 03 03 03 03 03 03 04 04 04 04 04 06 05 05 05 06 06 07 07 06 07 08 07 07 08 09 08 08 08 09 08 09 08 08 
02 03 02 02 03 02 03 03 03 03 04 05 04 04 04 04 08 06 05 05 07 06 07 05 05 07 10 08 08 08 09 09 08 08 09 09 10 09 08 08 
03 01 03 01 02 02 02 02 02 04 03 06 06 05 03 04 04 04 04 06 06 07 04 05 06 07 07 09 08 08 08 08 09 08 09 09 09 09 09 08 
01 03 01 02 02 02 02 03 03 03 06 05 03 03 04 04 05 05 05 05 08 05 06 07 07 07 08 07 08 07 08 08 08 09 08 09 09 08 08 09 
01 02 01 02 02 02 02 03 04 04 05 05 04 03 04 04 04 05 06 06 06 05 07 06 07 07 08 07 08 08 08 08 08 09 09 09 09 09 08 09 
