00 00 00 00 00 00 00 00 00 00 01 00 02 00 00 00 00 00 00 01 00 00 00 00 00 00 00 00 00 00 00 00 00 00 00 00 00 00 00 01 
00 00 00 00 00 00 00 00 01 00 00 02 00 00 00 01 00 01 01 00 00 00 00 00 00 01 00 00 00 00 00 00 00 00 00 00 00 01 00 00 
00 00 00 00 00 00 00 01 02 02 01 01 01 01 00 00 00 02 02 00 00 00 00 00 00 00 00 00 00 00 00 02 00 00 00 00 03 00 00 00 
00 00 00 00 00 00 01 02 03 01 01 01 02 00 00 00 01 02 03 00 00 00 00 00 00 00 00 00 00 01 00 00 00 00 01 00 00 00 00 00 
00 00 00 02 00 01 02 03 03 00 00 05 03 04 04 02 00 03 02 00 00 00 00 00 00 00 00 00 00 00 00 00 01 01 01 00 00 00 00 00 
00 02 00 00 03 01 03 03 05 02 01 03 04 04 04 02 02 02 01 00 00 00 00 00 00 00 00 00 00 00 00 00 01 00 00 01 00 00 00 00 
00 00 04 03 02 03 01 05 06 00 05 05 04 02 02 01 04 01 00 00 00 02 00 00 01 00 01 00 00 00 00 04 01 00 00 00 00 00 00 01 
01 01 01 04 03 03 06 07 07 06 03 06 04 03 01 02 00 00 00 00 00 00 02 01 00 01 00 02 01 01 01 00 01 00 00 00 00 02 01 00 
00 01 03 02 03 05 05 07 07 03 07 03 02 02 02 00 01 01 01 00 00 01 00 01 00 00 01 00 00 00 00 01 00 00 00 00 00 00 00 00 
01 00 01 02 00 00 00 01 00 00 02 02 01 01 01 00 00 00 00 00 00 00 00 00 00 00 00 00 00 00 00 00 00 00 00 00 00 00 00 00 
01 01 00 00 00 00 01 00 00 00 02 01 01 00 00 00 00 00 00 00 00 00 00 00 00 00 00 00 00 00 00 00 00 00 00 00 00 00 00 00 
00 01 03 01 01 00 00 00 00 00 01 01 00 00 00 00 01 00 00 00 00 01 00 00 00 00 00 00 00 00 00 02 00 00 00 00 00 00 00 01 
01 01 01 00 00 00 00 00 00 00 01 00 00 00 00 00 00 00 00 00 00 00 02 01 00 01 00 00 00 00 00 00 00 00 00 01 00 02 01 00 
01 01 00 00 00 00 00 00 00 00 00 00 00 00 00 00 00 00 00 00 00 01 00 01 00 00 00 00 00 00 00 00 00 00 00 00 00 00 00 00 
00 00 00 00 00 00 00 00 00 00 00 00 00 00 00 00 00 00 00 00 00 00 00 00 00 00 00 00 00 00 00 00 00 00 00 00 00 00 00 00 
00 00 00 01 00 00 00 00 00 00 00 00 00 00 00 01 00 00 00 00 00 00 00 00 00 01 00 00 00 00 00 00 00 00 00 00 00 00 00 00 
00 00 01 00 00 00 02 00 00 00 00 00 00 00 00 00 00 00 00 00 00 01 00 00 00 00 00 00 00 00 00 00 00 00 00 00 01 00 00 00 
00 00 00 01 00 00 00 00 00 00 00 00 00 00 00 00 00 00 00 00 00 00 00 00 00 00 00 01 00 00 00 00 00 00 00 00 00 00 00 00 
01 00 00 00 00 00 00 00 00 00 00 00 00 00 00 00 00 00 01 00 00 00 00 00 00 00 00 00 00 00 00 00 00 00 00 00 00 00 00 00 
00 00 00 00 00 00 03 00 00 00 00 00 01 02 03 02 04 01 01 01 00 00 00 00 00 00 00 00 00 01 01 00 01 00 00 00 00 00 00 00 
00 00 00 00 01 00 01 00 01 00 00 00 03 02 03 02 02 01 01 02 00 00 00 00 00 01 00 01 00 00 01 01 00 00 00 00 00 00 00 00 
00 00 00 01 00 03 00 01 00 00 00 05 03 03 01 03 00 01 00 00 00 01 00 00 00 00 03 01 00 02 01 01 00 00 00 00 00 00 00 00 
00 01 02 03 03 01 03 00 01 01 03 02 04 04 03 01 03 01 01 00 00 00 00 00 00 01 00 00 00 00 00 00 00 00 00 01 00 00 00 01 
01 01 03 04 01 04 00 01 00 02 01 04 03 04 01 04 00 01 00 01 00 00 00 00 00 00 00 01 01 00 00 00 01 00 00 00 00 01 01 01 
02 01 01 00 01 01 01 02 02 03 02 03 02 02 03 01 00 01 01 01 00 00 00 00 00 00 01 01 01 00 00 02 00 00 01 00 00 01 01 01 
01 01 01 01 00 01 01 03 01 03 04 02 03 01 01 01 00 01 00 00 01 00 00 00 00 00 01 01 02 01 01 01 01 01 01 00 01 01 00 00 
01 00 00 00 00 01 05 02 02 02 02 05 01 01 01 00 03 00 00 00 00 02 00 00 00 01 00 02 03 00 02 00 01 00 00 00 02 00 00 01 
00 00 00 00 01 01 01 02 02 03 03 02 02 01 00 00 00 01 00 00 01 00 00 00 00 00 02 03 03 02 00 02 00 00 00 00 00 02 01 00 
00 00 00 01 00 01 02 02 01 02 02 02 00 00 00 00 00 00 00 00 00 00 00 00 00 02 02 03 04 00 03 00 00 00 00 00 01 00 00 00 
00 00 00 00 00 00 00 01 00 00 01 01 02 01 01 00 00 00 00 01 00 00 00 01 01 00 03 01 01 02 00 00 00 00 00 00 00 00 00 00 
00 00 00 00 00 00 01 00 00 00 03 01 01 00 00 02 00 01 00 00 00 00 01 01 02 01 01 02 02 02 00 00 00 00 00 00 00 00 00 00 
00 00 00 00 01 01 01 00 00 00 01 05 01 01 00 00 03 00 00 00 00 01 02 03 00 03 02 02 00 00 00 01 00 00 00 00 00 00 00 00 
00 00 00 01 01 00 00 00 00 00 02 01 03 01 00 00 00 00 00 00 01 02 04 04 03 02 03 00 00 00 01 00 02 01 00 00 00 00 00 00 
00 00 00 00 00 00 00 00 00 00 01 02 00 01 00 00 00 00 00 00 01 03 03 03 02 03 00 00 00 00 00 01 00 01 00 00 00 00 00 00 
00 00 00 02 00 00 00 00 00 00 00 00 00 00 00 00 00 00 00 00 01 01 01 00 00 00 00 00 00 00 00 00 00 00 00 00 00 01 01 01 
00 02 00 02 02 00 00 00 00 00 00 00 00 00 00 01 00 00 00 00 01 01 00 00 00 00 00 00 00 00 00 00 00 00 00 01 00 01 00 00 
00 00 04 02 00 00 00 00 00 00 00 00 00 00 00 00 00 00 00 00 00 01 00 00 00 00 00 00 00 01 00 00 00 00 00 00 04 01 00 00 
01 01 00 00 00 00 00 00 00 00 00 00 00 00 00 00 00 01 00 00 00 00 00 00 00 00 00 02 01 00 01 00 00 00 00 01 00 00 00 00 
01 00 01 00 00 00 00 00 00 00 00 00 00 00 00 00 00 00 00 00 00 00 00 01 00 00 00 00 00 00 00 00 00 00 00 00 01 00 00 00 
00 00 00 00 00 00 00 00 00 00 00 00 00 00 00 00 00 00 00 00 00 00 00 00 00 00 01 00 00 00 00 00 00 00 00 00 00 00 00 00 
