40 40 40 38 40 40 36 38 35 34 33 35 33 35 36 37 40 40 39 39 39 40 40 42 43 43 47 45 46 46 46 45 47 46 46 45 49 47 48 48 
40 38 40 38 38 37 38 34 34 34 33 33 36 37 38 37 40 39 40 39 39 40 43 44 45 45 46 46 47 45 46 47 46 47 47 48 47 48 48 48 
40 40 36 36 40 36 34 34 34 32 34 36 39 40 38 41 38 39 37 39 40 41 45 46 44 48 44 47 46 47 46 45 47 48 45 48 51 49 48 48 
38 37 38 35 37 36 35 35 33 34 35 37 40 43 38 41 42 37 37 40 41 44 47 49 44 46 49 46 47 46 46 47 49 50 48 48 49 48 48 49 
40 38 40 39 33 33 33 33 32 37 39 32 41 38 37 43 44 39 40 42 44 42 48 46 45 50 50 48 49 45 46 48 50 49 49 51 48 48 46 46 
40 39 36 36 37 32 33 32 31 34 37 38 37 37 37 43 40 41 42 42 45 47 45 46 46 50 48 49 49 46 46 50 49 49 49 49 48 46 46 46 
36 38 39 35 35 33 31 31 30 41 34 42 39 40 41 42 40 43 44 47 44 46 46 46 47 48 50 49 49 48 50 50 48 46 46 47 47 46 46 46 
38 35 35 32 30 30 32 32 30 34 38 33 39 39 43 42 44 45 45 44 44 44 45 46 49 50 49 50 50 50 48 49 46 46 46 46 45 47 46 46 
34 36 33 30 31 32 30 30 30 37 32 39 41 41 41 44 43 44 46 43 43 46 48 47 48 48 50 50 49 48 49 47 47 46 45 45 46 46 46 45 
34 35 34 35 38 37 42 40 42 43 38 39 41 42 43 44 45 46 45 44 45 44 47 45 45 45 42 45 44 44 46 46 46 45 45 45 42 44 41 41 
34 36 36 38 40 41 39 43 42 42 41 40 43 43 44 43 46 45 46 44 45 46 45 43 43 43 44 44 43 43 47 45 45 43 43 43 44 41 41 41 
36 35 37 39 37 41 44 43 42 42 40 45 44 44 45 46 45 47 47 46 45 48 43 43 46 42 46 44 45 46 46 48 43 42 45 42 43 41 42 43 
35 38 39 41 43 43 44 43 43 41 43 43 43 44 46 45 47 46 47 46 46 43 45 42 42 44 42 47 45 46 44 44 44 42 41 42 40 44 42 43 
37 38 41 43 43 44 43 41 43 43 42 44 44 45 46 47 46 48 47 44 43 43 41 41 42 41 45 45 45 45 44 43 41 39 41 40 42 42 41 41 
39 40 40 40 43 43 41 42 42 42 43 44 44 44 44 46 47 48 48 44 43 48 45 46 46 43 43 45 44 44 42 43 42 41 41 41 42 41 41 41 
39 40 41 41 40 42 42 42 42 42 43 45 44 45 46 46 48 48 49 46 46 45 46 46 46 45 44 44 43 43 41 42 41 41 41 42 42 41 41 42 
41 41 40 41 41 41 44 42 42 42 45 41 45 45 46 48 49 49 49 43 47 49 46 44 44 44 47 43 42 42 42 43 41 41 41 42 40 41 40 40 
41 41 41 42 41 41 41 41 42 43 43 46 45 46 47 48 49 48 49 49 46 48 47 45 42 44 42 42 41 42 41 42 43 41 40 41 41 40 40 41 
41 41 40 41 41 40 42 43 41 43 46 44 47 46 47 49 49 50 51 45 49 46 43 43 43 42 42 42 41 41 42 41 40 39 40 41 40 41 39 41 
41 41 41 43 42 42 44 43 44 44 45 44 47 47 47 46 48 46 46 47 45 45 45 46 47 46 48 44 42 41 39 41 37 35 35 36 32 36 34 33 
41 42 41 44 43 43 43 44 45 44 46 46 47 47 47 48 47 47 46 46 46 44 47 46 47 44 46 41 42 41 38 38 35 35 33 35 36 33 34 35 
41 41 46 45 42 44 46 46 46 46 45 48 47 47 46 47 47 46 45 45 45 50 47 47 45 47 40 41 38 38 39 35 34 33 38 34 31 33 34 35 
42 44 42 44 45 45 46 48 47 46 46 46 46 47 47 45 47 45 45 46 48 46 47 47 46 42 44 38 39 38 35 37 35 33 32 33 32 34 34 37 
43 42 44 44 46 46 46 46 47 45 45 47 48 47 45 47 45 46 44 46 45 47 47 48 42 45 39 40 37 36 38 33 32 31 33 31 33 36 36 35 
43 43 43 43 45 45 46 48 49 46 45 49 46 46 46 45 43 44 43 43 45 45 42 40 40 40 39 37 37 35 34 33 33 33 34 33 37 36 37 38 
43 42 44 44 45 46 47 49 49 47 45 47 46 46 46 43 44 43 41 41 44 43 40 39 39 39 38 37 35 34 33 33 34 34 34 35 36 38 39 39 
44 43 44 45 46 46 50 50 50 45 49 45 45 43 43 43 44 41 41 41 43 41 39 37 37 38 37 35 34 34 33 34 34 34 34 37 37 39 38 38 
43 45 45 47 48 49 48 50 50 49 44 48 45 44 42 43 41 43 41 40 40 40 38 37 36 36 36 35 34 33 33 33 33 34 36 38 40 38 39 39 
45 44 46 47 48 48 50 50 51 46 49 44 43 44 43 41 41 40 39 39 40 38 37 36 36 36 34 33 32 32 32 34 35 34 37 40 38 39 39 41 
45 44 45 41 44 44 40 42 39 38 44 43 41 39 39 39 36 37 35 35 39 37 37 34 33 33 31 33 33 34 33 35 35 34 34 35 31 38 36 35 
45 43 44 41 42 42 42 38 38 39 43 42 39 39 37 37 37 35 35 36 38 38 33 33 32 33 32 34 33 33 34 35 34 33 32 36 36 35 35 35 
44 44 38 39 44 40 38 38 39 40 42 40 38 37 39 36 37 36 36 36 37 33 32 32 33 31 37 35 36 37 35 36 33 31 37 33 39 36 38 39 
43 39 41 37 38 38 37 40 39 40 38 39 38 37 36 35 34 35 35 37 33 34 34 32 32 36 33 38 37 37 33 34 32 31 33 37 33 38 37 40 
40 42 37 38 39 37 38 40 40 38 40 37 37 35 35 34 35 37 35 36 34 32 32 31 34 32 37 36 36 37 34 32 31 29 35 32 37 38 37 38 
39 38 41 39 38 38 39 37 35 35 37 39 35 35 35 34 35 35 35 35 33 37 35 35 35 36 35 38 38 38 33 36 36 37 37 37 38 39 39 39 
40 39 39 40 38 36 39 35 36 37 37 36 35 35 36 34 36 35 35 36 34 36 35 37 38 36 37 38 36 36 35 36 37 37 38 38 39 39 39 40 
38 40 38 37 39 39 34 36 36 36 38 36 36 34 33 36 34 35 35 35 38 33 36 34 34 36 40 37 36 36 37 38 38 38 38 39 40 40 40 41 
40 38 39 37 36 35 38 36 36 36 36 37 33 34 34 35 36 35 35 35 35 38 33 35 35 38 35 36 36 37 37 39 38 38 38 39 40 42 41 40 
39 40 36 36 36 38 35 36 35 35 37 34 35 34 35 36 34 35 36 35 39 34 36 36 36 35 37 37 36 36 39 38 38 39 39 40 40 40 40 40 
37 37 36 36 36 37 36 36 35 35 35 34 36 34 35 35 35 35 35 35 36 35 37 35 36 35 36 36 37 37 38 38 39 38 39 40 41 40 40 40 
