37 36 37 36 36 36 37 37 38 38 38 37 39 39 39 38 41 39 41 42 41 43 41 42 43 44 44 45 43 42 42 41 41 39 39 39 36 38 37 37 
37 37 36 37 36 37 37 38 38 37 37 39 39 39 40 39 38 42 42 42 43 42 43 43 43 43 45 42 43 41 41 41 39 38 37 37 38 37 37 37 
36 36 36 36 36 37 40 39 39 39 38 40 40 41 37 40 44 43 42 41 42 42 43 43 45 45 42 43 42 42 41 40 37 35 39 36 38 38 39 40 
36 37 37 36 38 38 38 39 39 39 39 39 42 42 40 41 42 42 43 41 42 43 44 45 43 45 45 42 41 41 40 39 35 34 38 36 37 40 40 40 
37 37 36 38 38 38 39 40 40 37 38 41 43 43 44 44 42 42 41 44 44 42 43 41 41 44 45 42 42 41 39 41 36 37 38 35 37 40 40 41 
36 37 37 39 39 39 39 41 41 39 40 42 44 43 43 41 43 41 42 43 41 44 41 41 42 44 43 42 42 41 38 37 38 38 39 38 39 41 41 42 
37 36 41 40 38 40 41 42 42 40 42 45 43 41 41 42 39 42 43 45 43 40 41 41 42 43 42 42 42 37 39 37 39 38 38 39 41 41 42 43 
37 38 37 39 40 40 42 42 43 43 42 43 41 41 41 41 41 43 43 41 40 41 41 41 43 42 43 44 43 39 39 40 38 39 39 40 42 44 43 42 
37 37 39 39 40 41 42 43 43 42 43 42 42 41 41 41 42 44 44 40 41 40 42 40 41 43 42 41 42 40 40 38 39 39 41 41 42 42 41 42 
38 38 39 39 38 39 43 42 42 43 42 42 42 42 42 42 42 43 43 40 41 39 43 42 42 41 44 42 43 44 38 40 38 36 36 37 33 39 36 36 
38 38 38 39 40 41 42 43 43 43 42 42 42 42 42 42 43 44 44 39 41 42 42 43 43 43 41 44 43 43 38 39 36 35 34 36 38 36 35 35 
38 39 40 41 40 44 42 42 40 39 42 42 42 42 43 42 43 44 46 43 41 42 43 44 40 43 46 44 43 43 39 38 35 32 39 34 38 35 36 37 
39 43 43 45 45 42 44 39 40 40 43 42 42 42 42 44 44 47 46 40 42 41 44 44 45 45 45 44 44 42 36 36 32 32 34 36 33 38 36 37 
42 42 44 45 42 45 40 41 40 41 42 42 42 41 43 43 45 46 46 40 40 43 45 45 44 45 44 42 44 44 37 33 33 31 33 32 36 36 35 35 
43 42 40 41 42 41 42 40 40 40 42 43 43 43 43 45 46 46 46 42 42 47 43 42 42 44 40 41 38 37 35 36 35 35 36 35 37 37 37 38 
41 41 41 39 40 41 41 40 41 41 41 43 43 44 44 46 47 47 48 44 44 45 42 43 44 41 42 37 37 38 35 35 36 36 36 37 36 38 36 36 
42 40 43 41 38 41 38 40 41 41 43 43 44 45 45 47 44 48 48 43 47 40 42 40 40 40 36 37 37 37 36 37 36 35 35 37 40 37 36 36 
40 40 38 38 39 38 41 41 41 42 43 44 45 45 46 46 48 47 49 46 43 46 42 41 38 36 36 36 36 38 37 36 34 35 36 38 38 38 37 35 
39 38 39 39 38 41 40 41 42 42 44 44 45 46 46 48 47 50 51 42 47 40 40 39 38 36 36 38 36 36 36 35 36 36 37 38 37 35 36 35 
39 39 38 39 40 39 38 37 36 36 35 37 36 37 38 39 39 40 37 36 42 42 42 41 41 40 38 38 37 37 37 36 37 36 36 35 37 37 38 39 
38 40 39 39 39 37 37 36 36 36 36 35 38 37 38 37 41 36 37 38 42 41 41 39 39 38 39 37 38 36 35 38 36 37 36 37 36 39 38 38 
39 38 41 39 38 37 37 37 37 35 37 41 39 38 40 40 36 37 36 36 41 44 39 38 40 37 36 38 38 38 37 35 37 37 35 37 41 39 38 38 
39 38 37 38 37 36 37 38 37 38 39 39 39 39 39 37 38 37 36 36 42 39 40 38 36 36 36 37 38 36 34 36 35 36 38 38 38 38 38 38 
37 37 38 37 36 37 37 37 36 38 39 39 38 40 36 38 36 36 34 34 39 39 37 36 35 36 37 39 40 35 36 35 38 37 37 38 38 38 39 39 
37 36 39 37 36 36 35 35 34 39 38 36 37 36 36 36 38 35 35 36 39 39 38 39 40 37 38 40 40 35 35 39 37 36 36 38 36 37 36 36 
38 38 37 37 36 35 36 34 34 37 37 36 36 34 34 35 36 36 36 36 41 37 40 39 39 38 39 40 41 37 36 38 36 37 38 37 37 36 36 36 
36 38 36 35 37 35 34 34 34 38 35 39 35 34 34 37 36 36 34 34 38 43 40 39 39 39 40 41 42 36 39 34 37 35 35 36 36 35 35 36 
38 36 37 35 33 33 34 34 33 35 36 33 34 34 35 34 37 34 35 34 39 39 40 40 39 41 41 43 42 39 35 39 35 36 35 36 35 36 35 36 
35 38 34 33 34 34 33 34 32 34 33 35 35 34 34 37 35 35 35 35 39 40 39 40 40 41 41 42 42 36 40 35 36 36 36 35 35 36 36 35 
35 35 34 34 35 34 39 36 37 38 34 34 34 34 34 34 36 35 35 35 38 38 38 38 38 37 39 37 37 37 35 35 36 36 36 35 37 35 35 35 
34 34 34 35 37 35 36 38 37 37 35 35 34 35 35 33 35 35 36 36 38 38 38 38 38 38 37 37 36 36 35 35 36 36 36 35 36 35 35 35 
35 34 35 37 34 38 39 37 35 35 34 33 35 36 34 36 34 35 34 34 37 39 38 39 37 38 40 37 35 35 35 40 37 38 35 37 36 35 35 35 
34 37 37 40 39 36 39 36 36 34 33 35 36 36 36 35 36 34 35 35 38 38 41 40 39 37 37 35 35 35 37 37 40 39 37 36 37 36 35 34 
37 36 39 40 36 40 36 35 34 36 34 35 37 37 36 36 34 35 36 36 38 39 39 39 37 38 36 35 35 35 36 39 37 37 35 37 35 34 34 34 
38 37 37 36 36 35 35 35 34 34 34 36 35 35 35 35 34 34 33 33 37 37 35 34 34 35 35 35 35 35 36 35 36 35 35 35 35 33 33 33 
37 36 36 36 35 34 35 34 34 34 35 35 35 35 35 33 35 33 34 34 37 36 34 35 36 36 35 35 34 34 36 35 35 33 33 34 34 33 33 34 
37 36 35 35 35 34 35 34 34 35 36 35 34 34 34 34 32 33 34 34 37 33 35 33 33 35 38 35 34 34 35 39 34 33 33 34 32 33 33 34 
36 34 35 34 34 35 34 36 35 34 33 36 35 34 33 33 34 35 34 34 35 35 32 33 35 36 34 35 34 34 36 33 34 33 33 33 34 34 34 34 
35 35 34 34 34 34 35 34 34 34 36 34 34 32 33 34 33 34 33 34 35 33 35 34 35 34 35 34 34 34 33 34 33 32 33 34 33 34 34 34 
34 34 34 34 34 34 35 34 34 34 35 34 34 33 33 34 34 34 34 34 34 33 35 35 35 34 34 34 34 34 33 33 33 33 33 34 34 34 34 34 
