40 38 37 35 35 34 31 31 29 29 27 27 24 23 23 22 21 20 17 17 16 14 13 13 13 11 12 09 08 08 07 07 04 03 03 03 01 02 00 00 
38 36 36 35 33 32 31 29 27 28 26 24 23 22 22 21 21 17 17 15 15 13 13 11 12 10 10 08 08 07 06 05 03 03 02 02 02 00 00 01 
37 36 34 32 33 30 32 27 25 25 25 25 22 21 22 21 16 16 15 15 13 15 12 11 10 10 09 07 06 06 06 04 03 02 03 01 00 00 00 01 
35 34 33 31 32 29 27 25 23 25 24 23 21 20 19 18 18 15 13 15 13 12 11 11 09 09 08 06 05 05 03 04 02 00 01 01 01 01 00 00 
35 33 33 28 27 26 25 23 21 25 23 20 19 17 17 18 18 14 13 12 11 11 11 09 08 09 07 05 03 06 04 03 00 00 00 00 01 00 00 00 
34 30 30 27 24 23 24 20 20 22 21 20 17 15 15 17 15 13 13 11 11 11 08 06 06 06 06 03 02 04 03 01 00 00 00 00 00 00 00 00 
31 31 24 23 25 24 22 19 17 22 19 18 15 15 15 16 14 13 12 11 10 11 06 04 04 06 04 02 01 03 01 00 00 00 00 01 01 00 00 01 
29 25 26 22 21 20 20 17 17 18 17 15 17 15 14 13 14 14 13 10 07 07 05 04 03 02 02 02 01 00 00 00 00 00 00 02 01 02 01 00 
25 27 21 21 20 20 18 18 16 17 15 15 14 13 13 14 13 12 13 06 07 05 04 04 02 02 01 01 02 01 00 00 00 00 00 01 01 00 01 01 
24 23 22 23 23 21 22 18 17 17 15 14 13 12 12 11 09 09 07 06 05 04 03 02 02 01 01 00 00 00 00 00 01 01 01 01 00 01 02 02 
23 24 22 22 22 20 19 17 16 16 13 13 12 10 10 10 10 07 07 05 03 03 02 01 01 01 00 00 00 00 02 00 01 00 00 01 00 02 01 01 
23 21 24 23 19 20 18 16 14 13 13 15 11 09 11 09 08 07 05 04 03 03 01 00 01 00 00 00 00 00 00 04 01 00 01 00 05 02 02 02 
21 21 20 21 19 16 17 14 14 13 10 10 09 08 08 07 05 04 04 03 01 01 00 00 00 00 00 00 00 00 02 00 01 00 01 03 01 02 02 02 
19 20 21 21 17 18 15 14 12 14 11 09 09 08 07 05 05 06 04 00 01 00 00 00 00 00 00 00 00 00 00 01 00 01 01 00 02 02 02 02 
20 18 21 20 15 14 12 11 08 07 08 10 06 06 06 05 05 04 02 00 00 00 00 00 00 00 00 00 00 00 01 02 02 01 01 02 02 02 02 02 
20 19 18 16 16 11 12 07 08 08 08 07 06 05 05 05 05 02 02 00 00 00 00 00 00 00 00 00 00 00 02 02 01 01 02 03 02 02 02 02 
17 19 19 14 14 12 06 07 06 06 09 06 05 03 02 05 01 01 00 00 00 00 00 00 00 00 03 00 00 01 02 03 02 01 01 02 03 02 03 03 
20 15 15 10 08 07 07 05 05 07 05 07 03 03 02 01 02 00 00 00 00 00 00 00 00 02 00 02 01 00 01 02 01 01 01 01 02 04 03 03 
14 16 10 08 08 08 05 07 04 05 08 03 03 02 02 03 00 01 01 00 00 00 00 00 00 00 01 00 00 00 02 01 01 02 01 02 03 02 03 02 
13 12 12 09 09 09 05 06 03 02 01 01 00 00 00 00 00 00 00 00 00 00 00 01 01 01 02 01 01 01 00 01 00 00 00 00 02 02 02 02 
12 10 10 08 07 06 07 02 03 01 02 01 00 00 00 00 00 00 00 00 00 00 01 00 01 02 01 01 01 01 00 00 00 01 01 01 02 02 02 02 
11 11 07 06 09 05 01 02 03 01 01 00 00 00 00 00 00 00 00 00 00 03 01 02 01 02 01 00 00 00 01 00 02 02 01 03 02 01 01 01 
10 05 06 03 03 01 02 03 02 00 01 00 00 00 00 00 00 01 00 00 01 01 03 02 02 01 02 02 01 01 02 02 03 03 03 02 03 02 01 00 
04 07 03 03 01 02 01 04 03 00 00 00 00 00 00 00 00 00 00 00 00 02 01 03 02 02 01 00 00 00 02 02 03 03 02 03 01 01 01 00 
04 03 05 02 01 01 02 02 01 00 00 00 00 00 00 00 00 00 00 00 01 01 00 00 00 00 00 00 00 02 02 01 02 02 02 01 02 00 00 00 
04 02 03 03 01 01 02 01 01 00 01 00 00 00 00 00 00 00 00 01 00 01 00 00 00 00 00 00 00 01 02 01 02 00 00 01 01 00 00 00 
02 04 00 00 03 03 00 01 00 00 00 01 00 00 00 00 00 00 00 01 01 00 00 00 00 00 00 00 00 02 01 05 01 00 00 01 00 00 00 00 
03 00 03 00 00 00 02 00 00 00 00 00 00 00 00 00 01 01 01 01 00 00 00 00 00 01 00 00 00 01 01 00 01 00 00 00 01 00 00 00 
01 03 00 00 00 02 00 01 00 01 00 00 00 01 00 01 00 01 02 01 00 00 00 00 00 00 00 00 00 00 00 01 00 00 00 01 00 00 00 01 
00 00 00 00 02 01 01 00 00 00 00 00 00 00 00 00 00 01 00 00 00 00 01 01 01 00 00 00 00 00 00 00 00 00 00 00 00 01 01 01 
00 01 01 00 01 01 00 00 00 00 00 00 00 00 00 00 01 00 00 00 00 00 01 00 00 00 00 00 00 00 00 00 00 00 00 00 00 01 00 00 
01 00 00 00 01 00 00 00 00 00 00 01 00 00 01 00 00 00 00 00 00 03 00 00 00 00 00 00 00 00 00 00 00 00 00 00 03 01 01 02 
00 00 00 00 00 00 00 00 00 01 01 01 02 01 00 00 00 00 00 00 01 00 01 00 00 00 00 00 00 00 00 00 00 00 00 02 00 03 01 01 
00 00 00 00 01 00 00 01 01 01 01 01 00 00 00 00 00 00 01 00 00 00 00 00 00 00 00 00 00 00 00 00 00 00 00 00 01 00 00 00 
00 00 02 03 00 00 00 01 00 00 00 00 00 00 00 00 00 00 00 00 00 01 00 00 00 00 00 00 00 00 00 01 01 01 01 01 01 00 00 00 
01 01 01 02 03 00 01 00 00 00 00 00 00 00 00 01 00 00 00 00 01 00 00 00 00 00 00 00 00 00 01 01 01 01 01 01 01 00 00 01 
00 02 04 02 02 00 00 00 00 00 00 00 00 00 00 00 03 00 00 00 01 00 00 00 00 00 01 00 00 01 01 04 01 00 00 01 00 00 00 00 
03 02 02 00 00 00 00 00 00 00 00 00 00 00 00 00 00 00 00 00 01 01 00 00 00 00 00 02 01 00 01 01 01 00 00 00 00 00 00 01 
00 03 01 00 00 00 00 00 01 00 00 00 00 01 00 00 00 00 00 00 01 00 00 01 00 00 01 00 00 00 01 01 00 01 00 00 00 01 00 01 
01 01 00 00 00 00 00 00 00 00 00 00 00 00 00 00 00 00 00 00 00 00 00 00 00 00 01 00 00 00 00 00 00 00 00 00 00 01 01 01 
