48 48 48 49 48 48 51 49 50 50 49 50 46 46 47 47 48 48 46 46 46 43 45 43 43 41 47 41 44 45 45 46 46 47 47 48 47 48 46 46 
48 49 48 49 49 50 49 50 49 50 48 48 47 47 47 47 49 46 46 44 44 45 43 45 45 43 42 45 45 45 47 46 47 47 47 47 49 46 46 46 
48 48 51 51 48 51 52 49 47 48 49 45 47 47 48 48 47 45 43 46 43 43 46 47 40 45 44 46 45 45 46 48 47 46 49 48 45 45 44 44 
49 50 49 51 50 50 50 47 47 46 47 48 48 48 47 47 47 43 42 44 43 45 48 49 42 43 46 45 47 46 47 47 46 47 47 47 47 44 42 42 
48 49 48 47 60 52 49 47 46 50 49 46 47 44 44 47 46 42 41 41 43 44 48 46 46 50 46 48 47 48 48 48 46 44 44 46 46 44 42 42 
48 49 51 48 47 50 47 46 44 48 47 47 44 43 43 44 43 41 41 42 44 47 46 47 48 50 47 47 45 48 46 48 44 44 45 45 44 42 40 40 
51 50 47 48 47 47 50 45 43 49 46 47 43 42 42 44 40 40 38 46 47 46 47 46 46 45 50 47 47 48 48 43 43 42 42 44 46 41 38 38 
49 47 47 45 47 47 44 43 43 45 45 42 42 41 42 40 41 38 39 47 46 47 46 46 47 48 44 46 46 46 43 45 43 42 42 42 41 38 38 38 
47 47 45 47 45 44 44 43 43 42 42 42 42 42 40 42 39 40 40 45 47 46 47 47 46 43 47 47 47 43 45 42 43 41 41 41 40 38 37 37 
46 46 45 45 47 46 47 44 43 43 42 42 41 40 40 39 40 39 38 46 43 45 39 38 38 39 35 39 37 36 43 41 43 41 41 40 39 38 40 41 
45 45 46 46 47 44 45 43 43 43 42 41 40 40 40 38 39 38 37 45 42 41 38 37 36 37 39 36 35 35 42 43 41 40 40 40 38 41 40 40 
46 45 46 46 45 46 44 43 41 41 41 41 41 41 39 40 38 37 35 41 42 39 37 35 40 36 37 35 35 35 42 41 40 39 39 38 42 42 43 43 
45 44 45 46 46 43 44 41 41 41 42 41 41 41 39 36 38 35 35 42 37 39 36 35 35 34 33 34 33 36 39 39 39 38 39 41 40 43 43 44 
44 44 46 47 43 45 41 42 41 41 41 41 41 42 35 38 35 35 34 38 40 36 35 34 33 33 34 35 33 33 39 38 39 38 40 39 42 43 44 45 
44 43 46 45 42 41 40 40 38 38 39 40 37 36 36 35 35 33 31 37 36 33 32 31 31 33 37 35 37 38 38 43 40 40 41 42 41 43 41 41 
45 44 44 43 43 41 40 38 37 37 38 38 36 34 34 35 34 31 31 35 34 33 31 32 33 36 35 38 38 38 40 42 41 42 43 40 44 41 43 44 
43 46 44 41 42 39 41 37 35 35 38 36 34 32 32 34 30 30 30 35 32 30 32 34 35 37 38 38 37 37 43 38 41 41 41 42 39 42 43 43 
46 40 43 39 37 37 36 36 35 35 36 35 33 32 31 30 32 30 30 30 32 32 35 35 36 38 39 36 38 38 39 44 41 41 41 41 41 41 42 46 
40 44 38 37 37 36 36 36 34 34 36 33 32 32 31 32 30 30 29 32 31 33 35 37 36 39 38 38 38 40 45 40 41 42 41 41 41 45 44 45 
40 39 41 39 38 40 38 42 40 39 38 37 36 36 36 35 36 34 36 37 32 33 34 34 34 35 38 38 39 39 40 40 42 43 43 43 46 46 46 47 
40 38 39 39 38 39 42 39 38 38 37 36 36 36 36 35 34 37 36 36 31 34 34 36 36 37 38 39 40 39 40 41 43 44 44 44 46 47 46 46 
39 41 37 37 42 40 40 38 37 37 36 36 36 35 34 35 38 37 36 36 34 33 36 37 36 39 40 41 41 41 41 43 45 46 44 47 49 47 45 45 
40 38 40 38 39 39 37 37 36 35 36 35 34 35 36 36 37 36 37 37 34 36 35 37 40 40 41 41 41 42 43 44 46 47 48 47 48 46 46 45 
39 41 37 38 37 37 37 37 35 35 35 35 36 34 36 37 37 36 37 38 35 36 39 39 40 41 40 41 41 43 43 46 47 49 47 48 46 45 45 45 
38 37 37 38 37 36 38 34 33 35 35 34 35 35 35 36 37 38 38 39 36 37 38 38 38 40 41 42 42 44 44 46 47 47 47 46 45 44 44 44 
37 36 37 36 37 35 36 33 34 34 36 35 35 36 36 36 38 39 40 41 35 38 38 39 40 41 42 42 43 45 46 46 47 45 45 45 45 44 43 43 
37 36 39 37 35 37 31 34 34 35 34 36 37 38 39 38 39 41 42 43 38 36 39 40 41 42 41 44 44 45 46 49 46 44 43 45 44 43 42 42 
37 36 34 33 34 33 36 35 34 34 35 36 39 39 39 41 41 43 43 44 37 40 40 41 42 43 44 44 45 47 45 45 43 43 44 44 43 42 42 42 
36 34 34 34 34 37 33 33 33 35 35 38 38 38 40 40 42 43 45 45 39 39 41 41 42 43 44 45 46 45 46 44 44 43 43 43 42 42 42 42 
34 36 34 33 43 41 39 36 37 37 35 38 36 36 36 38 33 40 35 34 38 39 39 37 37 38 34 40 38 37 43 43 42 41 41 41 42 41 40 40 
34 34 38 36 41 39 37 37 38 39 36 36 36 35 34 36 39 34 35 36 37 40 37 37 35 37 39 37 38 38 42 43 41 42 41 40 42 40 41 42 
38 36 33 36 39 37 35 38 39 40 38 38 35 33 41 35 35 35 36 37 40 38 36 34 40 36 39 39 39 40 43 40 42 42 41 42 38 40 40 40 
35 34 35 34 36 37 38 39 40 42 35 37 34 33 34 34 32 35 35 39 36 37 35 34 35 37 35 38 38 42 40 42 41 42 41 39 41 39 40 41 
34 35 34 37 38 37 38 41 41 43 38 34 32 32 33 31 35 38 37 36 38 35 35 33 35 34 38 41 40 40 42 41 43 41 40 41 39 41 40 41 
34 35 43 40 38 39 37 40 38 37 34 35 35 36 36 34 37 37 38 38 35 40 37 38 39 37 38 39 38 38 40 42 39 40 40 39 40 41 41 41 
38 38 40 40 41 38 40 37 37 38 35 34 36 35 35 35 37 38 38 39 36 38 39 39 39 36 40 38 39 40 39 40 40 40 40 41 40 41 40 40 
36 44 38 37 44 38 38 37 36 36 34 39 36 36 36 38 38 39 38 38 40 39 39 37 37 40 35 38 37 37 41 39 40 40 40 40 43 40 39 39 
45 39 45 39 36 37 35 35 35 38 37 36 37 37 36 38 40 38 38 38 38 42 39 39 36 37 39 36 37 39 39 41 41 40 39 39 40 38 39 40 
42 47 37 36 38 35 35 38 36 36 35 37 36 37 37 40 38 38 38 39 42 39 37 38 38 39 36 39 39 39 41 39 39 39 39 40 40 40 39 40 
40 41 37 36 36 35 35 36 37 36 36 37 37 37 38 39 38 39 38 39 40 39 39 36 37 38 37 39 39 39 40 40 40 39 39 39 39 40 40 40 
