01 01 01 02 01 01 00 01 00 00 00 01 00 01 02 02 04 04 04 04 04 04 04 03 03 04 04 06 05 05 04 06 03 04 04 05 06 07 06 06 
01 00 01 02 00 01 01 00 00 00 00 00 02 02 03 02 04 04 04 04 05 04 03 04 03 04 05 05 04 05 05 04 04 05 05 04 07 06 06 06 
01 01 03 01 02 01 01 00 00 00 01 00 02 02 03 04 04 04 04 04 04 04 04 04 05 05 07 05 04 03 05 03 06 06 06 07 06 06 05 05 
02 01 01 01 01 01 01 01 00 00 00 02 03 04 03 05 05 04 04 04 05 05 05 05 06 05 05 04 03 03 04 06 06 07 06 06 07 05 03 03 
02 01 02 02 00 00 01 00 00 02 03 01 04 03 03 05 05 05 05 05 05 05 06 04 04 05 04 02 01 07 07 03 05 03 02 07 08 06 06 07 
02 00 01 00 01 01 01 00 00 01 01 03 03 03 03 05 04 05 05 05 06 05 04 03 03 03 03 01 01 05 03 06 02 03 04 09 05 07 05 05 
01 01 02 01 01 01 00 00 00 04 02 03 03 04 04 05 08 06 06 05 05 07 04 03 03 03 00 00 00 08 04 01 03 04 05 06 10 06 05 05 
01 00 01 00 00 00 01 00 00 02 02 02 04 04 05 06 05 06 06 06 05 04 05 03 01 01 01 00 00 02 03 02 04 04 06 08 06 05 05 05 
01 01 00 00 00 01 00 01 01 03 02 03 04 04 04 05 06 05 05 03 04 04 02 01 00 01 00 00 00 02 01 03 05 06 05 06 06 05 04 06 
00 00 00 00 02 02 02 01 01 01 02 03 04 03 03 04 03 04 03 04 04 03 06 06 07 06 08 05 06 07 03 03 03 02 02 03 01 04 02 02 
00 00 01 00 02 01 02 01 02 02 04 03 03 03 03 02 05 03 04 03 05 05 07 06 07 07 05 07 06 06 03 03 02 02 01 02 03 02 02 03 
01 01 00 01 02 02 00 02 02 02 03 06 03 03 05 04 01 04 06 05 04 09 07 08 05 07 09 06 05 05 03 02 02 00 04 02 03 03 03 03 
00 00 01 01 02 02 02 01 02 03 03 03 03 03 03 02 04 07 06 05 06 05 08 08 08 07 08 06 06 04 02 02 00 00 01 03 01 03 03 04 
00 01 00 02 03 02 01 03 03 03 03 03 03 03 03 04 04 06 06 05 04 08 08 09 07 08 06 05 05 05 02 00 01 00 03 01 03 04 03 03 
00 00 02 04 02 02 02 03 03 04 03 05 03 04 05 04 05 06 06 06 06 08 07 06 06 06 04 04 02 02 01 03 01 01 02 02 03 03 02 02 
01 02 02 03 05 03 03 04 03 03 03 04 05 05 05 04 06 07 08 07 06 07 06 05 05 05 04 02 02 02 00 02 02 03 03 01 03 02 02 03 
01 03 06 04 04 03 05 03 03 03 05 04 05 04 04 06 06 08 07 06 08 06 05 03 03 04 04 02 01 01 03 00 02 01 01 03 01 02 02 02 
04 04 03 03 02 04 03 03 03 04 04 05 03 04 05 06 07 06 07 08 05 06 04 03 02 02 01 01 01 02 01 03 00 01 02 02 03 02 02 03 
03 03 03 02 03 03 03 03 03 03 05 04 05 05 06 07 06 09 08 06 07 03 03 02 02 01 01 02 02 01 04 00 02 01 02 03 01 03 01 03 
03 03 03 04 03 03 01 02 01 01 00 01 00 01 01 01 02 04 04 04 03 04 02 02 02 02 01 02 02 03 04 03 07 06 06 05 10 05 07 08 
03 03 03 03 02 02 03 01 01 01 01 00 01 01 01 02 03 04 03 03 02 03 02 02 01 02 02 03 04 03 03 06 06 07 08 06 06 08 09 09 
03 03 05 03 04 02 00 00 00 00 01 00 02 02 02 03 06 03 02 02 03 01 01 00 03 01 02 04 06 06 04 06 08 10 04 09 07 09 07 07 
04 01 02 00 01 01 00 00 00 01 01 02 02 02 04 03 03 03 02 02 01 02 00 00 01 04 03 07 07 04 07 06 09 10 09 07 11 07 09 08 
00 02 01 00 00 00 00 01 00 01 02 01 02 04 02 03 03 02 03 02 02 00 01 00 03 02 05 07 09 06 05 09 11 11 09 12 08 08 09 10 
01 00 02 02 00 00 01 01 01 01 01 00 01 01 01 02 03 02 02 02 01 02 04 04 05 05 07 09 09 07 07 12 09 09 09 08 05 08 06 05 
01 01 01 01 02 02 01 02 01 00 00 01 01 01 01 02 02 02 03 03 02 03 05 05 06 06 08 10 12 09 07 10 09 09 09 08 07 05 04 04 
00 01 03 01 02 01 04 01 01 01 00 01 01 01 01 03 02 03 03 03 02 06 06 08 09 09 09 12 13 07 12 08 08 06 05 05 07 04 03 03 
02 01 01 00 00 01 01 02 01 00 01 00 00 00 02 02 03 03 03 03 06 06 09 09 09 09 12 12 14 12 09 12 07 06 04 05 02 03 02 04 
00 01 00 00 01 01 01 00 00 01 00 00 01 00 01 03 02 03 03 04 05 08 08 08 10 12 12 15 15 10 13 06 05 04 04 02 03 04 01 02 
00 00 00 01 03 02 04 01 02 02 00 01 02 03 03 03 05 03 02 02 05 06 04 04 04 05 05 07 05 05 08 07 05 04 04 03 02 02 01 01 
00 01 01 02 03 01 02 02 02 03 02 01 03 03 04 03 04 02 03 04 04 05 04 05 04 05 07 05 05 05 08 06 04 03 03 03 02 01 00 00 
01 00 03 03 01 03 03 03 03 03 01 05 04 05 03 05 00 03 03 03 06 02 04 04 06 06 07 05 04 04 06 06 03 03 03 02 03 01 00 00 
01 02 01 03 03 03 04 03 03 03 05 04 07 06 04 02 05 04 03 02 03 06 04 05 06 04 05 05 04 03 05 04 04 03 02 01 00 01 00 00 
00 01 03 04 03 04 03 03 02 04 03 05 05 06 02 06 02 03 03 02 06 04 05 05 04 05 04 04 04 02 04 03 02 03 01 00 00 00 00 00 
02 02 04 03 03 03 02 03 02 02 04 04 03 02 02 02 03 01 00 00 04 04 04 03 03 03 04 03 03 03 03 02 00 00 00 00 00 00 00 00 
03 02 03 03 03 03 03 02 01 01 03 03 02 02 02 02 02 00 01 02 04 04 03 03 03 04 03 03 02 02 02 01 00 00 00 00 00 00 00 00 
02 04 02 02 04 02 04 02 02 03 03 03 02 01 01 02 00 01 01 02 04 04 03 02 02 03 06 02 01 01 01 00 00 00 01 00 00 00 00 00 
04 02 04 02 01 02 01 04 02 02 03 02 02 01 01 00 02 02 02 02 03 03 02 02 02 03 03 03 02 00 00 01 02 01 00 00 00 00 00 00 
01 04 01 01 01 01 02 02 02 01 02 01 01 01 01 02 01 02 02 02 03 02 02 03 02 03 03 01 01 00 01 00 00 00 00 00 00 00 01 00 
02 02 01 01 01 01 02 01 02 02 01 01 01 01 01 02 02 02 02 02 02 02 02 02 02 02 02 01 00 00 01 01 00 00 00 00 00 00 00 00 
