05 04 04 06 04 04 07 05 05 06 05 05 04 05 06 05 09 05 06 06 05 07 04 03 03 05 01 06 02 01 00 01 00 01 01 01 03 01 01 02 
04 05 04 06 05 04 05 06 05 05 06 04 06 06 07 06 06 06 06 06 05 05 03 03 02 03 06 01 02 01 00 00 01 01 02 00 02 02 02 03 
04 04 09 08 04 07 07 05 03 04 04 06 07 08 04 08 05 06 04 05 06 01 02 01 07 03 01 01 02 00 00 00 02 02 01 03 01 02 02 02 
06 06 05 07 05 07 07 03 03 05 05 05 09 10 04 06 07 03 04 03 04 05 01 01 04 03 03 03 01 00 01 01 02 03 01 02 03 02 03 04 
04 05 04 02 11 08 06 02 01 04 06 02 07 04 04 10 09 05 05 08 06 05 01 01 01 00 02 01 01 01 02 00 03 03 03 04 05 05 05 06 
04 05 07 05 01 04 04 01 01 03 05 07 04 04 05 08 06 06 06 06 05 02 01 00 00 01 01 01 01 00 01 02 03 03 03 05 04 06 06 06 
07 05 01 03 02 04 00 00 00 08 04 05 05 06 07 07 06 06 07 04 03 02 01 00 00 02 00 01 00 03 01 03 03 03 03 04 07 06 07 08 
04 02 03 02 03 02 01 00 00 03 04 02 06 05 08 08 07 08 08 03 01 01 00 00 00 00 02 00 00 01 02 01 02 03 05 05 06 09 08 07 
03 03 01 04 01 01 00 00 00 02 01 05 07 07 06 06 07 07 08 02 01 00 00 00 00 03 00 00 00 01 01 03 04 04 05 06 07 07 07 08 
02 02 02 03 02 02 07 04 05 06 03 04 06 08 09 09 13 11 12 00 02 00 05 03 03 02 03 01 02 02 01 03 01 01 01 03 00 05 03 02 
02 02 02 03 04 05 05 06 07 07 05 05 09 10 11 10 11 13 13 00 01 04 03 03 03 03 02 02 04 05 02 02 01 01 00 02 04 02 02 02 
02 02 04 05 02 07 06 07 06 06 05 08 11 12 09 13 14 13 12 04 02 06 04 04 02 03 00 04 04 04 03 00 01 00 05 02 04 02 02 02 
02 05 05 08 08 07 10 07 07 05 08 09 12 13 14 13 15 13 13 03 03 02 03 03 02 01 04 03 05 06 00 02 00 00 02 01 00 02 01 03 
06 04 07 09 07 10 06 05 07 06 08 11 13 16 13 16 13 11 12 02 01 03 04 02 03 04 03 06 06 07 03 00 00 00 00 00 01 02 01 00 
06 06 04 03 07 06 06 06 06 07 10 09 10 10 10 12 12 13 13 02 02 09 05 06 06 03 01 04 01 01 00 00 00 00 00 00 02 01 01 01 
05 05 05 04 03 06 06 07 07 07 10 11 10 11 11 14 12 13 13 05 04 05 06 06 06 02 04 01 01 02 01 00 00 00 00 00 01 01 02 02 
06 04 02 04 05 06 07 07 07 08 10 07 10 11 12 12 16 14 14 02 09 08 06 03 02 03 00 01 01 02 00 00 00 00 00 02 00 01 01 02 
03 03 04 05 07 07 07 07 08 09 10 10 11 11 13 13 13 15 15 10 06 10 04 04 00 00 01 02 01 02 00 00 00 00 00 01 03 03 02 01 
02 04 05 07 06 06 07 08 08 09 09 10 12 13 12 13 15 14 16 08 11 05 02 02 02 01 00 02 01 00 00 00 00 00 01 03 01 01 03 02 
04 04 03 06 04 03 08 04 05 05 05 05 05 03 03 03 01 04 02 02 05 05 05 05 05 04 08 05 06 06 06 05 05 05 05 04 07 04 05 06 
03 05 03 07 06 03 05 05 07 05 04 06 03 03 02 02 03 02 03 03 04 05 05 06 06 05 05 06 06 05 05 05 05 06 06 05 04 06 05 05 
04 03 09 08 03 08 03 07 06 06 05 02 02 02 04 02 03 03 05 06 04 06 07 08 04 07 06 06 04 06 05 05 06 08 03 06 05 05 04 04 
04 07 06 09 08 06 10 06 07 04 02 03 02 01 01 04 02 06 05 06 05 06 08 08 08 05 08 05 05 04 04 06 09 08 07 04 07 06 05 03 
06 05 09 09 08 10 06 07 08 01 03 01 02 01 03 01 04 05 04 05 05 07 08 10 06 08 05 05 05 05 05 07 08 10 05 08 05 04 03 04 
07 07 06 05 07 07 07 07 07 02 02 07 04 05 05 03 03 03 01 01 05 05 04 04 04 05 05 05 05 05 05 06 06 05 05 04 03 03 01 01 
06 06 06 06 05 07 07 07 08 04 04 05 05 05 05 02 04 01 02 03 05 05 04 04 04 06 05 05 05 05 07 05 05 04 04 03 03 01 01 01 
07 06 05 06 06 07 05 08 09 02 07 06 04 02 01 03 00 01 01 01 04 04 04 03 03 05 07 06 05 05 06 08 04 02 02 02 01 01 01 02 
05 06 06 07 07 06 08 09 09 08 04 07 03 03 00 01 01 00 00 02 03 03 02 03 05 05 05 04 05 06 05 04 02 02 02 02 01 03 02 01 
06 05 06 07 06 07 08 10 10 05 08 03 02 00 01 01 00 02 01 01 03 03 04 03 04 05 05 06 05 05 05 03 02 01 01 01 01 01 02 01 
06 05 05 06 04 04 08 05 04 04 03 03 02 02 02 01 03 02 01 01 02 03 02 01 01 01 00 02 00 00 03 03 03 03 03 02 03 01 01 01 
05 04 04 05 06 05 06 04 05 05 04 03 02 02 02 03 02 01 01 01 03 02 01 01 00 02 02 00 00 01 03 03 03 03 03 03 02 01 02 02 
05 05 07 07 04 08 05 04 02 02 02 02 02 02 01 02 03 02 00 00 02 02 01 00 02 01 01 00 00 00 02 04 03 03 02 03 00 01 01 01 
05 08 07 08 08 04 07 04 03 01 01 02 01 02 03 01 02 00 00 01 00 01 01 00 00 00 00 00 00 01 03 03 05 04 02 01 02 01 01 01 
07 06 08 09 05 08 03 02 02 02 02 02 03 02 02 02 00 01 00 01 01 00 00 01 01 00 00 01 00 00 02 04 03 04 01 02 00 01 00 02 
08 07 05 04 04 03 03 01 01 01 01 02 01 00 00 01 00 01 00 00 00 00 00 00 00 00 01 00 00 00 02 02 02 02 02 01 01 01 00 00 
06 06 04 03 02 02 02 01 01 01 01 01 00 00 01 00 00 00 00 00 01 00 00 00 00 00 00 00 00 00 02 01 02 01 01 00 01 00 00 01 
06 04 03 02 01 02 00 00 00 00 02 01 00 00 00 00 02 00 00 00 00 02 00 00 00 01 00 00 00 00 02 04 01 00 00 01 00 01 01 01 
03 01 01 00 01 00 01 00 00 00 01 01 00 00 00 00 00 00 00 00 01 00 00 00 00 00 01 00 00 00 01 01 00 00 00 00 01 01 01 02 
02 01 00 01 00 01 00 00 01 00 01 00 00 00 00 00 00 00 00 00 00 00 00 01 00 01 00 00 00 00 01 01 00 01 00 01 00 01 01 01 
00 00 00 00 00 00 00 00 00 00 00 00 00 00 00 00 00 00 00 00 00 00 00 00 00 00 00 00 00 00 00 00 00 00 00 01 01 01 02 02 
