02 01 02 02 01 01 05 03 04 04 03 03 02 01 01 01 00 00 00 00 00 00 00 00 00 00 01 01 01 01 00 01 00 01 01 01 03 02 02 02 
02 02 01 03 03 04 03 04 04 03 01 03 01 01 00 01 00 00 00 00 00 00 00 00 00 01 00 01 00 01 01 00 01 01 02 01 02 02 02 02 
01 01 03 04 01 05 06 05 03 03 02 01 01 00 01 00 00 00 00 00 00 00 00 00 00 01 03 01 00 00 00 02 02 02 01 03 01 02 00 00 
02 03 03 06 03 03 06 03 03 02 00 01 00 00 00 00 00 00 01 00 00 00 01 01 01 01 01 00 00 01 01 02 03 04 01 03 03 00 00 00 
02 04 01 03 10 08 06 04 04 02 01 02 01 01 01 00 00 01 00 00 00 00 01 01 01 01 01 00 00 01 02 00 03 01 01 04 03 00 00 00 
01 02 05 04 03 07 04 04 02 02 02 01 01 00 00 01 01 00 00 00 01 01 01 00 00 01 00 00 00 00 02 03 01 01 01 03 01 00 00 00 
06 03 05 05 01 04 07 03 01 01 02 04 01 00 00 01 00 00 00 01 01 03 01 01 01 00 00 00 00 03 01 03 01 01 01 02 00 00 00 00 
03 04 02 03 04 03 01 01 01 02 02 01 00 00 00 00 00 00 00 01 02 01 02 01 00 00 00 01 00 01 01 00 02 01 01 01 00 00 00 00 
04 01 03 04 01 01 02 02 02 02 01 01 00 00 00 00 00 01 01 00 01 01 00 01 00 00 00 00 00 00 00 01 01 00 00 00 00 00 00 00 
03 02 02 03 02 01 01 00 00 00 00 01 00 00 00 00 00 00 00 01 00 00 00 00 00 00 00 00 00 00 00 00 00 00 00 00 00 00 00 00 
02 02 02 01 01 01 01 00 00 00 00 00 00 00 00 00 00 00 00 00 00 00 00 00 00 00 00 00 00 00 00 00 00 00 00 00 00 00 00 00 
02 02 04 02 01 00 00 00 00 00 00 01 00 00 00 00 00 00 00 00 00 01 00 00 00 00 01 00 00 01 00 00 00 00 00 00 02 00 00 00 
02 01 01 00 00 00 00 00 00 01 00 00 01 00 00 00 00 00 00 00 01 00 02 01 00 01 00 02 01 00 00 00 00 00 01 00 00 00 00 00 
00 01 01 00 01 00 00 00 00 00 00 00 00 00 00 00 00 00 01 00 00 01 00 00 00 00 01 00 00 00 00 00 00 01 00 00 00 00 01 00 
00 00 01 02 00 00 00 00 00 00 00 00 00 00 00 00 00 00 00 00 00 00 00 00 01 00 00 00 00 00 00 00 00 00 00 00 00 00 00 00 
00 01 00 00 02 00 00 00 00 00 00 00 00 00 00 00 00 00 00 00 00 00 01 00 00 00 00 00 00 00 01 00 00 00 00 01 00 00 00 00 
00 01 04 02 01 00 00 00 00 00 00 00 00 00 00 00 00 00 00 00 00 03 00 00 01 00 00 00 00 01 00 00 00 00 00 00 00 00 00 00 
02 01 01 00 00 00 00 01 00 00 00 00 00 00 00 00 00 00 00 00 01 00 02 01 00 01 00 02 01 00 01 00 00 00 00 00 00 00 00 00 
01 01 01 00 00 00 00 00 00 00 00 00 00 00 00 00 00 00 00 00 00 01 00 00 00 00 00 00 00 00 00 00 00 00 00 00 00 00 00 00 
00 00 00 00 00 00 00 00 01 01 02 00 02 02 02 01 05 02 03 04 00 00 00 00 00 00 00 00 00 00 00 00 00 00 00 00 00 00 00 00 
00 00 00 00 00 00 00 01 01 00 01 02 02 03 03 03 02 04 04 05 00 00 00 00 00 00 00 00 00 00 00 00 00 00 00 00 00 00 00 00 
00 00 00 00 00 00 02 02 02 03 01 00 03 04 01 05 04 05 03 03 00 00 00 00 00 00 00 00 00 00 00 02 00 00 00 00 00 00 00 00 
00 00 00 00 00 01 01 03 03 00 01 02 03 04 05 03 07 04 05 03 00 00 00 00 00 00 00 00 00 00 01 00 00 00 00 00 00 00 00 00 
00 00 00 00 00 01 02 02 02 02 01 03 06 07 04 07 04 04 05 05 00 00 00 00 00 00 00 00 00 00 00 00 00 01 01 00 00 00 00 00 
00 00 00 00 01 02 03 04 05 02 02 06 05 05 05 04 02 03 01 00 00 00 00 00 00 00 00 00 00 00 00 00 00 00 00 00 00 00 00 00 
00 00 00 00 01 02 04 05 06 04 04 05 05 04 04 01 03 00 00 01 00 00 00 00 00 00 00 00 00 00 00 00 00 00 00 00 00 00 00 00 
00 00 01 02 02 04 06 06 06 03 06 08 05 02 02 02 01 00 01 01 00 00 00 00 00 00 00 00 00 00 00 00 00 00 00 00 01 00 00 00 
00 01 01 02 04 05 06 06 07 07 05 06 03 02 01 01 00 02 01 01 00 00 01 00 00 00 00 02 01 00 00 00 00 00 00 00 00 01 00 00 
01 01 02 03 04 05 06 07 08 06 07 03 02 00 01 00 01 01 00 00 00 00 00 01 00 00 00 00 00 01 00 00 00 00 00 00 00 00 00 00 
01 01 01 03 01 01 03 04 04 04 03 03 03 02 02 01 01 00 00 00 00 00 00 01 01 00 02 01 01 01 00 00 00 00 00 00 00 00 00 00 
01 02 01 01 02 03 03 04 02 02 04 02 02 01 01 00 00 00 00 00 00 00 01 00 01 01 01 01 00 00 00 00 00 00 00 00 00 00 00 00 
01 01 06 04 02 03 06 03 01 01 02 06 02 00 01 00 00 00 00 00 00 03 01 02 00 01 04 01 00 00 00 01 00 00 00 00 03 00 00 00 
02 04 03 04 04 02 03 02 01 01 03 01 01 00 00 00 00 00 00 00 01 01 03 02 02 01 01 00 00 00 00 00 00 00 00 00 00 01 00 00 
03 02 04 03 01 03 02 01 01 00 01 01 00 00 00 00 00 00 00 00 00 02 01 01 00 01 01 00 00 00 00 00 00 00 00 00 00 00 01 00 
03 02 02 03 02 01 02 01 01 02 00 00 00 00 00 00 00 01 01 01 00 01 00 00 00 00 00 00 00 00 00 00 00 00 00 00 00 00 00 01 
02 02 02 02 02 02 01 02 00 00 00 00 00 00 00 01 00 01 00 00 00 00 00 00 00 00 00 00 00 00 00 00 00 00 00 01 00 01 00 00 
02 01 04 02 00 01 04 01 00 00 00 00 00 00 00 00 04 01 00 00 00 01 00 00 00 00 00 00 00 00 00 00 00 00 00 00 03 00 00 00 
02 01 00 00 00 01 01 01 00 00 00 00 00 00 00 02 00 00 00 00 00 00 00 00 00 00 00 00 00 00 00 00 00 00 00 00 00 01 00 00 
01 00 01 00 00 01 01 00 01 00 00 00 00 00 00 00 01 00 00 00 00 00 00 01 00 00 00 00 00 00 00 00 00 00 00 00 00 00 00 00 
00 00 00 00 00 00 00 00 00 00 00 00 00 00 01 00 00 00 00 00 00 00 00 00 00 00 00 00 00 00 00 00 00 00 00 00 00 00 00 00 
