02 02 01 02 02 01 01 01 00 00 00 00 00 01 01 01 02 03 03 03 02 04 03 02 02 03 01 04 02 02 01 01 00 00 00 00 01 00 01 02 
01 02 01 01 01 00 01 00 00 00 00 00 01 01 01 02 02 03 03 03 04 03 02 02 01 02 04 02 01 01 00 01 00 00 00 00 00 02 02 02 
02 01 03 02 01 00 01 00 00 00 00 02 02 02 02 03 05 03 03 02 03 04 02 00 04 02 04 01 01 01 01 00 00 01 00 01 01 02 02 02 
02 01 01 00 01 00 00 00 00 01 02 01 02 03 03 03 03 03 03 03 02 03 00 00 04 01 01 01 00 00 00 01 01 01 00 01 02 02 03 03 
01 00 01 01 00 00 00 01 01 01 01 00 02 02 02 03 04 04 05 05 03 03 02 02 02 00 01 00 00 01 01 00 01 01 01 02 03 03 03 04 
01 02 00 01 01 00 00 01 00 00 01 02 02 02 02 04 03 06 04 04 02 01 02 00 00 00 00 00 00 00 01 01 01 01 02 02 03 04 05 05 
00 01 02 01 01 00 03 00 00 02 01 02 02 03 04 03 08 05 05 02 01 05 01 00 00 01 00 00 00 01 00 00 01 01 01 03 03 05 06 06 
01 01 01 00 00 01 00 02 01 01 01 02 05 04 04 05 04 05 05 02 01 00 00 00 00 01 01 00 00 00 00 00 00 01 03 03 05 06 06 07 
00 01 00 00 00 00 01 00 00 01 01 03 03 05 03 04 05 04 04 00 00 01 00 00 00 01 00 00 00 00 00 00 03 02 03 04 05 06 06 07 
00 00 00 00 00 00 05 03 04 05 02 03 03 03 03 03 04 05 05 00 01 00 03 02 02 01 03 01 02 03 00 02 02 03 03 04 05 07 07 07 
00 00 00 02 02 03 03 05 05 05 02 03 03 04 03 04 05 06 06 00 01 03 02 02 02 03 01 03 03 03 02 01 03 04 04 05 06 07 05 05 
00 00 00 02 01 05 05 05 04 04 03 02 04 04 04 05 06 06 07 03 01 03 03 03 01 02 03 04 04 04 02 04 05 04 05 06 09 06 04 04 
00 01 04 07 06 05 07 06 05 03 03 04 04 04 05 06 07 09 08 01 02 01 02 02 03 03 04 05 05 04 03 04 03 05 07 05 06 05 04 04 
02 03 05 06 05 08 05 04 04 04 04 03 05 04 05 06 07 07 09 01 00 02 04 03 02 04 04 04 06 05 04 04 05 06 05 06 05 04 04 03 
03 03 02 01 05 04 04 04 04 05 03 05 06 07 07 06 07 08 08 01 01 06 03 03 03 03 01 03 01 01 03 02 03 01 01 04 05 03 03 03 
02 02 03 03 01 04 04 05 04 04 05 05 07 06 06 07 08 08 09 03 03 04 03 04 05 03 03 01 01 01 03 03 01 02 02 04 04 03 04 04 
04 02 00 02 02 04 05 05 04 04 05 10 07 08 08 08 07 09 09 02 07 03 04 01 00 02 02 01 01 01 03 00 02 03 03 05 02 03 03 03 
01 02 02 03 04 04 04 03 04 06 07 07 10 08 07 08 09 09 10 07 03 06 00 01 00 01 00 01 00 02 01 02 04 03 03 02 05 04 04 03 
02 01 02 04 03 04 04 05 04 06 07 08 07 08 07 09 09 10 10 05 07 01 02 00 01 00 00 01 00 00 02 02 03 02 02 05 03 03 03 04 
02 02 02 04 02 02 03 02 01 01 00 01 00 00 01 01 03 03 03 03 03 02 03 02 02 02 02 01 01 01 00 01 00 00 00 01 00 02 01 01 
02 03 02 03 02 02 03 01 02 01 00 00 01 02 02 02 03 03 03 03 02 02 02 02 02 01 02 01 01 01 00 00 00 00 00 01 02 01 01 01 
02 02 06 04 02 03 00 02 01 00 01 00 02 02 02 04 05 03 01 01 02 05 03 03 02 02 00 01 00 00 01 00 00 00 02 01 03 01 01 01 
03 03 03 05 03 01 03 02 02 01 02 02 01 03 04 03 04 02 02 01 03 02 03 02 02 01 01 00 00 01 00 01 00 00 01 01 00 02 01 01 
03 02 04 03 01 03 01 02 01 01 02 02 04 04 04 04 02 02 01 01 02 02 02 01 00 01 00 01 01 00 01 00 00 01 00 00 01 01 00 00 
03 02 02 03 01 01 01 00 00 02 02 01 02 01 01 02 02 02 02 03 01 02 00 00 00 00 00 00 00 00 00 00 00 00 00 00 01 01 02 03 
02 02 01 02 03 00 01 00 00 01 00 02 01 01 01 03 01 03 01 01 00 01 00 00 00 00 00 00 00 00 01 00 00 00 00 01 01 03 02 02 
02 02 05 02 01 01 00 00 00 02 01 02 01 01 01 02 06 02 02 02 02 01 00 00 00 00 00 00 00 00 00 00 00 00 00 01 03 02 02 02 
02 03 01 01 00 00 00 00 00 01 01 00 00 00 02 03 02 04 03 01 01 01 00 00 00 00 00 00 00 00 00 00 00 00 01 02 02 02 02 02 
02 01 01 00 00 00 00 00 01 01 00 00 01 01 01 02 03 01 01 02 01 00 00 01 00 00 00 00 00 00 00 00 01 01 01 02 02 02 02 03 
01 01 00 00 02 01 01 00 01 01 00 00 00 00 00 00 00 01 00 00 00 00 00 00 00 00 02 01 01 01 00 00 01 02 02 02 06 03 03 04 
00 00 01 01 01 01 00 01 00 00 00 00 00 00 00 00 01 00 00 00 01 00 00 01 01 02 01 01 01 01 02 01 02 03 04 03 04 04 05 06 
01 00 01 01 01 00 02 01 00 00 00 00 00 00 01 00 01 00 00 00 00 01 01 02 00 02 02 01 01 01 01 03 04 06 02 06 02 04 04 04 
00 00 00 00 00 00 00 00 00 01 00 00 00 00 00 00 00 00 00 01 00 01 02 02 02 00 02 02 01 00 03 03 06 06 06 02 07 06 05 03 
01 00 00 00 00 00 00 01 00 01 00 00 00 00 00 00 00 00 01 00 00 01 02 03 00 02 01 00 01 01 02 05 06 07 04 08 04 04 03 04 
00 00 02 01 00 00 00 01 00 00 00 01 00 00 00 00 00 01 01 02 00 01 01 01 01 00 00 01 00 00 03 03 03 03 03 04 03 04 03 03 
01 00 01 01 01 00 01 00 00 00 01 00 00 00 00 00 00 02 01 01 02 00 01 00 00 00 00 00 00 00 02 03 03 03 03 04 03 03 03 03 
00 02 01 00 02 00 00 00 00 00 01 01 00 00 00 00 03 01 01 01 01 03 01 01 01 00 02 00 00 00 03 03 03 02 02 03 06 04 04 04 
02 00 02 00 00 00 00 00 00 00 00 01 00 00 00 01 01 02 01 01 01 01 03 01 00 01 00 00 00 01 01 03 01 02 03 03 03 04 03 04 
00 02 00 00 00 00 00 00 00 00 01 00 00 01 01 01 01 01 00 01 01 01 00 01 00 00 00 00 00 00 03 02 03 01 03 03 03 03 03 03 
00 01 00 00 00 00 00 00 00 00 00 00 01 00 01 01 01 01 01 01 01 01 00 00 00 00 00 00 01 01 02 02 03 03 03 03 03 03 04 04 
